(supertux-level
  (version 2)
  (name (_ "Surviving in lava"))
  (author "Hume")
  (license "GPL 2+ / CC-by-sa 3.0")
  (sector
    (name "main")
    (init-script "import(\"levels/hume_rainbow_cave/defualt.nut\")
wait(5)
propadak0.goto_node(1)
propadak1.goto_node(1)
wait(55)
finish_level_group(\"orange\",\"o6\")")
    (ambient-light
      (color 1 0.6666667 0)
    )
    (camera
      (mode "normal")
    )
    (music
      (file "music/bossattack.ogg")
    )
    (path
      (name "81aa2ec9-a3cb-4c0d-aa4f-6304ae140582")
      (path
        (node
          (x 64)
          (y 256)
        )
        (node
          (x -64)
          (y 256)
        )
      )
    )
    (path
      (name "f4a4ea5c-f1bd-43a2-8d74-3ce99113ad41")
      (path
        (node
          (x 192)
          (y 32)
        )
        (node
          (x 160)
          (y 32)
        )
      )
    )
    (platform
      (running #f)
      (name "propadak0")
      (path-ref "81aa2ec9-a3cb-4c0d-aa4f-6304ae140582")
      (sprite "images/objects/platforms/big.sprite")
    )
    (platform
      (running #f)
      (name "propadak1")
      (path-ref "f4a4ea5c-f1bd-43a2-8d74-3ce99113ad41")
      (sprite "images/objects/platforms/vertical-wood.sprite")
    )
    (spawnpoint
      (name "main")
      (x 96)
      (y 128)
    )
    (tilemap
      (solid #f)
      (z-pos -100)
      (name "Background")
      (width 35)
      (height 25)
      (tiles
      2647 2648 2649 2650 2647 2648 2649 2650 2647 2648 2649 2650 2647 2648 2649 2650 2647 2648 2649 2650 2647 2648 2649 2650 2647 2648 2649 2650 2647 2648 2649 2650 2647 2648 2649
      2651 2652 2653 2654 2651 2652 2653 2654 2651 2652 2653 2654 2651 2652 2653 2654 2651 2652 2653 2654 2651 2652 2653 2654 2651 2652 2653 2654 2651 2652 2653 2654 2651 2652 2653
      2647 2648 2649 2650 2647 2648 2649 2650 2647 2648 2649 2650 2647 2648 2649 2650 2647 2648 2649 2650 2647 2648 2649 2650 2647 2648 2649 2650 2647 2648 2649 2650 2647 2648 2649
      2651 2652 2653 2654 2651 2652 2653 2654 2651 2652 2653 2654 2651 2652 2653 2654 2651 2652 2653 2654 2651 2652 2653 2654 2651 2652 2653 2654 2651 2652 2653 2654 2651 2652 2653
      2647 2648 2649 2650 2647 2648 2649 2650 2647 2648 2649 2650 2647 2648 2649 2650 2647 2648 2649 2650 2647 2648 2649 2650 2647 2648 2649 2650 2647 2648 2649 2650 2647 2648 2649
      2651 2652 2653 2654 2651 2652 2653 2654 2651 2652 2653 2654 2651 2652 2653 2654 2651 2652 2653 2654 2651 2652 2653 2654 2651 2652 2653 2654 2651 2652 2653 2654 2651 2652 2653
      2647 2648 2649 2650 2647 2648 2649 2650 2647 2648 2649 2650 2647 2648 2649 2650 2647 2648 2649 2650 2647 2648 2649 2650 2647 2648 2649 2650 2647 2648 2649 2650 2647 2648 2649
      2651 2652 2653 2654 2651 2652 2653 2654 2651 2652 2653 2654 2651 2652 2653 2654 2651 2652 2653 2654 2651 2652 2653 2654 2651 2652 2653 2654 2651 2652 2653 2654 2651 2652 2653
      2647 2648 2649 2650 2647 2648 2649 2650 2647 2648 2649 2650 2647 2648 2649 2650 2647 2648 2649 2650 2647 2648 2649 2650 2647 2648 2649 2650 2647 2648 2649 2650 2647 2648 2649
      2651 2652 2653 2654 2651 2652 2653 2654 2651 2652 2653 2654 2651 2652 2653 2654 2651 2652 2653 2654 2651 2652 2653 2654 2651 2652 2653 2654 2651 2652 2653 2654 2651 2652 2653
      2647 2648 2649 2650 2647 2648 2649 2650 2647 2648 2649 2650 2647 2648 2649 2650 2647 2648 2649 2650 2647 2648 2649 2650 2647 2648 2649 2650 2647 2648 2649 2650 2647 2648 2649
      2651 2652 2653 2654 2651 2652 2653 2654 2651 2652 2653 2654 2651 2652 2653 2654 2651 2652 2653 2654 2651 2652 2653 2654 2651 2652 2653 2654 2651 2652 2653 2654 2651 2652 2653
      2647 2648 2649 2650 2647 2648 2649 2650 2647 2648 2649 2650 2647 2648 2649 2650 2647 2648 2649 2650 2647 2648 2649 2650 2647 2648 2649 2650 2647 2648 2649 2650 2647 2648 2649
      2651 2652 2653 2654 2651 2652 2653 2654 2651 2652 2653 2654 2651 2652 2653 2654 2651 2652 2653 2654 2651 2652 2653 2654 2651 2652 2653 2654 2651 2652 2653 2654 2651 2652 2653
      2647 2648 2649 2650 2647 2648 2649 2650 2647 2648 2649 2650 2647 2648 2649 2650 2647 2648 2649 2650 2647 2648 2649 2650 2647 2648 2649 2650 2647 2648 2649 2650 2647 2648 2649
      2651 2652 2653 2654 2651 2652 2653 2654 2651 2652 2653 2654 2651 2652 2653 2654 2651 2652 2653 2654 2651 2652 2653 2654 2651 2652 2653 2654 2651 2652 2653 2654 2651 2652 2653
      2647 2648 2649 2650 2647 2648 2649 2650 2647 2648 2649 2650 2647 2648 2649 2650 2647 2648 2649 2650 2647 2648 2649 2650 2647 2648 2649 2650 2647 2648 2649 2650 2647 2648 2649
      2651 2652 2653 2654 2651 2652 2653 2654 2651 2652 2653 2654 2651 2652 2653 2654 2651 2652 2653 2654 2651 2652 2653 2654 2651 2652 2653 2654 2651 2652 2653 2654 2651 2652 2653
      2647 2648 2649 2650 2647 2648 2649 2650 2647 2648 2649 2650 2647 2648 2649 2650 2647 2648 2649 2650 2647 2648 2649 2650 2647 2648 2649 2650 2647 2648 2649 2650 2647 2648 2649
      2651 2652 2653 2654 2651 2652 2653 2654 2651 2652 2653 2654 2651 2652 2653 2654 2651 2652 2653 2654 2651 2652 2653 2654 2651 2652 2653 2654 2651 2652 2653 2654 2651 2652 2653
      2647 2648 2649 2650 2647 2648 2649 2650 2647 2648 2649 2650 2647 2648 2649 2650 2647 2648 2649 2650 2647 2648 2649 2650 2647 2648 2649 2650 2647 2648 2649 2650 2647 2648 2649
      2651 2652 2653 2654 2651 2652 2653 2654 2651 2652 2653 2654 2651 2652 2653 2654 2651 2652 2653 2654 2651 2652 2653 2654 2651 2652 2653 2654 2651 2652 2653 2654 2651 2652 2653
      2647 2648 2649 2650 2647 2648 2649 2650 2647 2648 2649 2650 2647 2648 2649 2650 2647 2648 2649 2650 2647 2648 2649 2650 2647 2648 2649 2650 2647 2648 2649 2650 2647 2648 2649
      2651 2652 2653 2654 2651 2652 2653 2654 2651 2652 2653 2654 2651 2652 2653 2654 2651 2652 2653 2654 2651 2652 2653 2654 2651 2652 2653 2654 2651 2652 2653 2654 2651 2652 2653
      2647 2648 2649 2650 2647 2648 2649 2650 2647 2648 2649 2650 2647 2648 2649 2650 2647 2648 2649 2650 2647 2648 2649 2650 2647 2648 2649 2650 2647 2648 2649 2650 2647 2648 2649
      )
    )
    (tilemap
      (solid #t)
      (z-pos 0)
      (name "Interactive")
      (width 35)
      (height 25)
      (tiles
      2471 2472 2507 2508 2507 2508 2507 2508 2507 2508 2507 2508 2507 2508 2507 2508 2507 2508 2507 2508 2507 2508 2507 2508 2507 2508 2507 2508 2507 2508 2507 2507 2508 2469 2470
      2485 2486 0 0 0 0 0 0 0 0 0 0 0 0 0 0 0 0 0 0 0 0 0 0 0 0 0 0 0 0 0 0 0 2483 2484
      2499 2500 0 0 0 0 0 0 0 0 0 0 0 0 0 0 0 0 0 0 0 0 0 0 0 0 0 0 0 0 0 0 0 2497 2498
      2513 2514 0 0 0 0 0 0 0 0 0 0 0 0 0 0 0 0 0 0 0 0 0 0 0 0 0 0 0 0 0 0 0 2511 2512
      2495 2496 0 0 0 103 0 0 0 0 0 0 0 0 0 0 0 0 0 0 0 0 0 0 0 0 0 0 0 0 0 0 0 2463 2464
      2467 2468 0 0 0 0 0 0 0 0 0 0 0 0 0 0 0 0 0 0 0 0 0 0 0 0 0 0 0 0 0 0 0 2477 2478
      2481 2482 0 0 0 0 0 0 0 0 0 0 0 0 0 0 0 0 0 0 0 0 0 0 0 0 0 0 0 0 0 0 0 2491 2492
      2495 2496 0 0 0 0 0 0 0 0 0 0 0 0 0 0 0 0 0 0 0 0 0 0 0 0 0 0 0 0 0 0 0 2463 2464
      2467 2468 0 0 0 0 0 0 0 0 0 0 0 0 0 0 0 0 0 0 0 0 0 0 0 0 0 0 0 0 0 0 0 2477 2478
      2481 2482 0 0 0 0 0 0 0 0 0 0 0 0 0 0 0 0 0 0 0 0 0 0 0 0 0 0 0 0 0 0 0 2491 2492
      2495 2496 0 0 0 0 0 0 0 0 0 0 0 0 0 0 0 0 0 0 0 0 0 0 0 0 0 0 0 0 0 0 0 2463 2464
      2467 2468 0 0 0 0 0 0 0 0 0 0 0 0 0 0 0 0 0 0 0 0 0 0 0 0 0 0 0 0 0 0 0 2477 2478
      2481 2482 0 0 0 0 0 0 0 0 0 0 0 0 0 0 0 0 0 0 0 0 0 0 0 0 0 0 0 0 0 0 0 2491 2492
      2495 2496 0 0 0 0 0 0 0 0 0 0 0 0 0 0 0 0 0 0 0 0 0 0 0 0 0 0 0 0 0 0 0 2463 2464
      2467 2468 0 0 0 0 0 0 0 0 0 0 0 0 0 0 0 0 0 0 0 0 0 0 0 0 0 0 0 0 0 0 0 2477 2478
      2481 2482 0 0 0 0 0 0 0 0 0 103 103 103 103 102 102 102 103 103 103 103 103 0 0 0 0 0 0 0 0 0 0 2491 2492
      2495 2496 0 0 0 0 0 0 0 0 0 0 0 0 0 0 0 0 0 0 0 0 0 0 0 0 0 0 0 0 0 0 0 2463 2464
      2467 2468 0 0 0 0 0 0 0 0 0 0 0 0 0 0 0 0 0 0 0 0 0 0 0 0 0 0 0 0 0 0 0 2477 2478
      2481 2482 0 0 0 0 0 0 0 0 0 0 0 0 0 0 0 0 0 0 0 0 0 0 0 0 0 0 0 0 0 0 0 2491 2492
      2495 2496 0 0 0 0 0 0 0 0 103 103 103 103 103 102 102 102 103 103 103 103 103 103 0 0 0 0 0 0 0 0 0 2463 2464
      2467 2468 0 0 0 0 0 0 0 0 0 0 0 0 0 0 0 0 0 0 0 0 0 0 0 0 0 0 0 0 0 0 0 2477 2478
      2415 2416 0 0 0 0 0 0 0 0 0 0 0 0 0 0 0 0 0 0 0 0 0 0 0 0 0 0 0 0 0 0 0 2491 2492
      2429 2430 2423 2424 2423 2424 2423 2424 2423 2424 2423 2424 2423 2424 2423 2424 2423 2424 2423 2424 2423 2424 2423 2424 2423 2424 2423 2424 2423 2424 2423 2424 2423 2413 2414
      2443 2444 2437 2438 2437 2438 2437 2438 2437 2438 2437 2438 2437 2438 2437 2438 2437 2438 2437 2438 2437 2438 2437 2438 2437 2438 2437 2438 2437 2438 2437 2438 2437 2427 2428
      2457 2458 2451 2452 2451 2452 2451 2452 2451 2452 2451 2452 2451 2452 2451 2452 2451 2452 2451 2452 2451 2452 2451 2452 2451 2452 2451 2452 2451 2452 2451 2452 2451 2441 2442
      )
    )
    (tilemap
      (solid #t)
      (z-pos -1)
      (name "Lava")
      (width 35)
      (height 25)
      (tiles
      0 0 0 0 0 0 0 0 0 0 0 0 0 0 0 0 0 0 0 0 0 0 0 0 0 0 0 0 0 0 0 0 0 0 0
      0 0 0 0 0 0 0 0 0 0 0 0 0 0 0 0 0 0 0 0 0 0 0 0 0 0 0 0 0 0 0 0 0 0 0
      0 0 0 0 0 0 0 0 0 0 0 0 0 0 0 0 0 0 0 0 0 0 0 0 0 0 0 0 0 0 0 0 0 0 0
      0 0 0 0 0 0 0 0 0 0 0 0 0 0 0 0 0 0 0 0 0 0 0 0 0 0 0 0 0 0 0 0 0 0 0
      0 0 0 0 0 0 0 0 0 0 0 0 0 0 0 0 0 0 0 0 0 0 0 0 0 0 0 0 0 0 0 0 0 0 0
      0 0 0 0 0 0 0 0 0 0 0 0 0 0 0 0 0 0 0 0 0 0 0 0 0 0 0 0 0 0 0 0 0 0 0
      0 0 0 0 0 0 0 0 0 0 0 0 0 0 0 0 0 0 0 0 0 0 0 0 0 0 0 0 0 0 0 0 0 0 0
      0 0 0 0 0 0 0 0 0 0 0 0 0 0 0 0 0 0 0 0 0 0 0 0 0 0 0 0 0 0 0 0 0 0 0
      0 1708 1708 1708 1708 1708 1708 1708 1708 1708 1708 1708 1708 1708 1708 1708 1708 1708 1708 1708 1708 1708 1708 1708 1708 1708 1708 1708 1708 1708 1708 1708 1708 1708 0
      0 1705 1705 1705 1705 1705 1705 1705 1705 1705 1705 1705 1705 1705 1705 1705 1705 1705 1705 1705 1705 1705 1705 1705 1705 1705 1705 1705 1705 1705 1705 1705 1705 1705 0
      0 1705 1705 1705 1705 1705 1705 1705 1705 1705 1705 1705 1705 1705 1705 1705 1705 1705 1705 1705 1705 1705 1705 1705 1705 1705 1705 1705 1705 1705 1705 1705 1705 1705 0
      0 1705 1705 1705 1705 1705 1705 1705 1705 1705 1705 1705 1705 1705 1705 1705 1705 1705 1705 1705 1705 1705 1705 1705 1705 1705 1705 1705 1705 1705 1705 1705 1705 1705 0
      0 1705 1705 1705 1705 1705 1705 1705 1705 1705 1705 1705 1705 1705 1705 1705 1705 1705 1705 1705 1705 1705 1705 1705 1705 1705 1705 1705 1705 1705 1705 1705 1705 1705 0
      0 1705 1705 1705 1705 1705 1705 1705 1705 1705 1705 1705 1705 1705 1705 1705 1705 1705 1705 1705 1705 1705 1705 1705 1705 1705 1705 1705 1705 1705 1705 1705 1705 1705 0
      0 1705 1705 1705 1705 1705 1705 1705 1705 1705 1705 1705 1705 1705 1705 1705 1705 1705 1705 1705 1705 1705 1705 1705 1705 1705 1705 1705 1705 1705 1705 1705 1705 1705 0
      0 1705 1705 1705 1705 1705 1705 1705 1705 1705 1705 1705 1705 1705 1705 1705 1705 1705 1705 1705 1705 1705 1705 1705 1705 1705 1705 1705 1705 1705 1705 1705 1705 1705 0
      0 1705 1705 1705 1705 1705 1705 1705 1705 1705 1705 1705 1705 1705 1705 1705 1705 1705 1705 1705 1705 1705 1705 1705 1705 1705 1705 1705 1705 1705 1705 1705 1705 1705 0
      0 1705 1705 1705 1705 1705 1705 1705 1705 1705 1705 1705 1705 1705 1705 1705 1705 1705 1705 1705 1705 1705 1705 1705 1705 1705 1705 1705 1705 1705 1705 1705 1705 1705 0
      0 1705 1705 1705 1705 1705 1705 1705 1705 1705 1705 1705 1705 1705 1705 1705 1705 1705 1705 1705 1705 1705 1705 1705 1705 1705 1705 1705 1705 1705 1705 1705 1705 1705 0
      0 1705 1705 1705 1705 1705 1705 1705 1705 1705 1705 1705 1705 1705 1705 1705 1705 1705 1705 1705 1705 1705 1705 1705 1705 1705 1705 1705 1705 1705 1705 1705 1705 1705 0
      0 1705 1705 1705 1705 1705 1705 1705 1705 1705 1705 1705 1705 1705 1705 1705 1705 1705 1705 1705 1705 1705 1705 1705 1705 1705 1705 1705 1705 1705 1705 1705 1705 1705 0
      0 1705 1705 1705 1705 1705 1705 1705 1705 1705 1705 1705 1705 1705 1705 1705 1705 1705 1705 1705 1705 1705 1705 1705 1705 1705 1705 1705 1705 1705 1705 1705 1705 1705 0
      0 1705 1705 1705 1705 1705 1705 1705 1705 1705 1705 1705 1705 1705 1705 1705 1705 1705 1705 1705 1705 1705 1705 1705 1705 1705 1705 1705 1705 1705 1705 1705 1705 1705 0
      0 0 0 0 0 0 0 0 0 0 0 0 0 0 0 0 0 0 0 0 0 0 0 0 0 0 0 0 0 0 0 0 0 0 0
      0 0 0 0 0 0 0 0 0 0 0 0 0 0 0 0 0 0 0 0 0 0 0 0 0 0 0 0 0 0 0 0 0 0 0
      )
    )
  )
)
