(supertux-level
  (version 3)
  (name (_ "credits"))
  (author "Jojo")
  (license "CC-BY-SA 4.0 International")
  (sector
    (name "main")
    (ambient-light
      (color 1 0.8 0.9)
    )
    (camera
      (name "Camera")
      (mode "normal")
    )
    (fish
      (direction "left")
      (x 608)
      (y 608)
    )
    (fish
      (direction "left")
      (x 800)
      (y 480)
    )
    (gradient
      (top_color 0 0 0.65)
      (bottom_color 1 1 0.6)
    )
    (mrtree
      (direction "left")
      (x 1216)
      (y 320)
    )
    (music
      (file "/music/misc/credits.music")
    )
    (particles-clouds
    )
    (scripttrigger
      (script "Tux.deactivate();
Camera.scroll_to(240, 0, 6);
wait(107);")
      (button #f)
      (width 32)
      (height 32)
      (x 416)
      (y 480)
    )
    (spawnpoint
      (name "main")
      (x 416)
      (y 480)
    )
    (textscroller
      (file "/levels/The Big Island/forest1/creditstext.stxt")
    )
    (tilemap
      (solid #f)
      (z-pos -100)
      (width 45)
      (height 30)
      (tiles
      0 0 0 0 0 0 0 1168 1169 1170 0 0 0 0 0 0 0 0 0 0 0 0 0 0 0 0 0 0 0 0 0 0 0 0 0 0 1174 1175 1176 1177 0 0 0 0 0
      0 0 0 0 0 0 0 1174 1175 1176 1177 0 0 0 0 0 0 0 0 0 0 0 0 0 0 0 0 0 0 0 0 0 0 0 0 1179 1180 1181 1182 1183 0 0 0 0 0
      0 0 0 0 0 0 1179 1180 1181 1182 1183 0 0 0 0 0 0 0 0 0 0 0 0 0 0 0 0 0 0 0 0 0 0 0 0 1185 1186 1187 1188 1189 1190 0 0 0 0
      0 0 0 0 0 0 1185 1186 1187 1188 1189 1190 0 0 0 0 0 0 0 0 0 0 0 0 0 0 0 0 0 0 0 0 0 0 0 1191 1192 1193 1194 1195 1196 0 0 0 0
      0 0 0 0 0 0 1191 1192 1193 1194 1195 1196 0 0 0 0 0 0 0 0 0 0 0 0 0 0 0 0 0 0 0 0 0 0 0 1197 1198 1199 1200 1201 1202 0 0 0 0
      0 0 0 0 0 0 1197 1198 1199 1200 1201 1202 0 0 0 0 0 0 0 0 0 0 0 0 0 0 0 0 0 0 0 0 0 0 0 1203 1204 1205 1206 1207 1208 0 0 0 0
      0 0 0 0 0 0 1203 1204 1205 1206 1207 1208 0 0 0 0 0 0 0 0 0 0 0 0 0 0 0 0 0 0 0 0 0 0 0 1209 1210 1211 1212 1213 1214 0 0 0 0
      0 0 0 0 0 0 1209 1210 1211 1212 1213 1214 0 0 0 0 0 0 0 0 0 0 0 0 0 0 0 0 0 0 0 0 0 0 0 0 2045 1219 1220 0 0 0 0 0 0
      0 0 0 0 0 0 0 2045 1219 1220 0 0 0 0 0 0 0 0 0 0 0 0 0 0 0 0 0 0 0 0 0 0 0 0 0 0 2046 1225 1226 0 0 0 0 0 0
      0 0 0 0 0 0 0 2046 1225 1226 0 0 0 0 0 0 0 0 0 0 0 0 0 0 0 0 0 0 0 0 0 0 0 0 0 0 0 1217 1218 0 0 0 0 0 0
      0 0 0 0 0 0 0 0 1217 1218 0 0 0 0 0 0 0 0 0 0 0 0 0 0 0 0 0 0 0 0 0 0 0 0 0 0 0 1223 1224 0 0 0 0 0 0
      0 0 0 0 0 0 0 0 1223 1224 0 0 0 0 0 0 0 0 0 0 0 0 0 0 0 0 0 0 0 0 0 0 0 0 0 0 0 1217 1218 0 0 0 0 0 0
      0 0 0 0 0 0 0 0 1217 1218 0 0 0 0 0 0 0 0 0 0 0 0 0 0 0 0 0 0 0 0 0 0 402 403 404 405 0 1223 1224 402 403 434 435 404 405
      0 0 0 402 403 404 405 0 1223 1224 402 403 434 435 404 405 0 0 0 0 0 0 0 0 0 0 0 0 0 0 0 0 406 407 408 409 1228 1229 1230 406 407 438 439 408 409
      0 317 318 406 407 408 409 1228 1229 1230 406 407 438 439 408 409 0 0 0 0 0 0 0 0 0 0 0 0 0 0 0 0 410 411 412 413 1234 1235 1236 410 411 450 451 412 413
      0 319 320 410 411 412 413 1234 1235 1236 410 411 450 451 412 413 0 0 0 0 0 0 0 0 0 0 0 0 0 0 0 0 0 0 0 0 0 0 0 0 0 0 0 0 0
      0 0 0 0 0 0 0 0 0 0 0 0 0 0 0 0 0 0 0 0 0 0 0 0 0 0 0 0 0 0 0 0 0 0 0 0 0 0 0 0 0 0 0 0 0
      0 0 0 0 0 0 0 0 0 0 0 0 0 0 0 0 0 0 0 0 0 0 0 0 0 0 0 0 0 0 0 0 0 0 0 0 0 0 0 0 0 0 0 0 0
      0 0 0 0 0 0 0 0 0 0 0 0 0 0 0 0 0 0 0 0 0 0 0 0 0 0 0 0 0 0 0 0 0 0 0 0 0 0 0 0 0 0 0 0 0
      0 0 0 0 0 0 0 0 0 0 0 0 0 0 0 0 0 0 0 0 0 0 0 0 0 0 0 0 0 0 0 0 0 0 0 0 0 0 0 0 0 0 0 0 0
      0 0 0 0 0 0 0 0 0 0 0 0 0 0 0 0 0 0 0 0 0 0 0 0 0 0 0 0 0 0 0 0 0 0 0 0 0 0 0 0 0 0 0 0 0
      0 0 0 0 0 0 0 0 0 0 0 0 0 0 0 0 0 0 0 0 0 0 0 0 0 0 0 0 0 0 0 0 0 0 0 0 0 0 0 0 0 0 0 0 0
      0 0 0 0 0 0 0 0 0 0 0 0 0 0 0 0 0 0 0 0 0 0 0 0 0 0 0 0 0 0 0 0 0 0 0 0 0 0 0 0 0 0 0 0 0
      0 0 0 0 0 0 0 0 0 0 0 0 0 0 0 0 0 0 0 0 0 0 0 0 0 0 0 0 0 0 0 0 0 0 0 0 0 0 0 0 0 0 0 0 0
      0 0 0 0 0 0 0 0 0 0 0 0 0 0 0 0 0 0 0 0 0 0 0 0 0 0 0 0 0 0 0 0 0 0 0 0 0 0 0 0 0 0 0 0 0
      0 0 0 0 0 0 0 0 0 0 0 0 0 0 0 0 0 0 0 0 0 0 0 0 0 0 0 0 0 0 0 0 0 0 0 0 0 0 0 0 0 0 0 0 0
      0 0 0 0 0 0 0 0 0 0 0 0 0 0 0 0 0 0 0 0 0 0 0 0 0 0 0 0 0 0 0 0 0 0 0 0 0 0 0 0 0 0 0 0 0
      0 0 0 0 0 0 0 0 0 0 0 0 0 0 0 0 0 0 0 0 0 0 0 0 0 0 0 0 0 0 0 0 0 0 0 0 0 0 0 0 0 0 0 0 0
      0 0 0 0 0 0 0 0 0 0 0 0 0 0 0 0 0 0 0 0 0 0 0 0 0 0 0 0 0 0 0 0 0 0 0 0 0 0 0 0 0 0 0 0 0
      0 0 0 0 0 0 0 0 0 0 0 0 0 0 0 0 0 0 0 0 0 0 0 0 0 0 0 0 0 0 0 0 0 0 0 0 0 0 0 0 0 0 0 0 0
      )
    )
    (tilemap
      (solid #t)
      (z-pos 100)
      (width 45)
      (height 30)
      (tiles
      0 0 0 0 0 0 0 0 0 0 0 0 0 0 0 0 0 0 0 0 0 0 0 0 0 0 0 0 0 0 0 0 0 0 0 0 0 0 0 0 0 0 0 0 0
      0 0 0 0 0 0 0 0 0 0 0 0 0 0 0 0 0 0 0 0 0 0 0 0 0 0 0 0 0 0 0 0 0 0 0 0 0 0 0 0 0 0 0 0 0
      0 0 0 0 0 0 0 0 0 0 0 0 0 0 0 0 0 0 0 0 0 0 0 0 0 0 0 0 0 0 0 0 0 0 0 0 0 0 0 0 0 0 0 0 0
      0 0 0 0 0 0 0 0 0 0 0 0 0 0 0 0 0 0 0 0 0 0 0 0 0 0 0 0 0 0 0 0 0 0 0 0 0 0 0 0 0 0 0 0 0
      0 0 0 0 0 0 0 0 0 0 0 0 0 0 0 0 0 0 0 0 0 0 0 0 0 0 0 0 0 0 0 0 0 0 0 0 0 0 0 0 0 0 0 0 0
      0 0 0 0 0 0 0 0 0 0 0 0 0 0 0 0 0 0 0 0 0 0 0 0 0 0 0 0 0 0 0 0 0 0 0 0 0 0 0 0 0 0 0 0 0
      0 0 0 0 0 0 0 0 0 0 0 0 0 0 0 0 0 0 0 0 0 0 0 0 0 0 0 0 0 0 0 0 0 0 0 0 0 0 0 0 0 0 0 0 0
      0 0 0 0 0 0 0 0 0 0 0 0 0 0 0 0 0 0 0 0 0 0 0 0 0 0 0 0 0 0 0 0 0 0 0 0 0 0 0 0 0 0 0 0 0
      0 0 0 0 0 0 0 0 0 0 0 0 0 0 0 0 0 0 0 0 0 0 0 0 0 0 0 0 0 0 0 0 0 0 0 0 0 0 0 0 0 0 0 0 0
      0 0 0 0 0 0 0 0 0 0 0 0 0 0 0 0 0 0 0 0 0 0 0 0 0 0 0 0 0 0 0 0 0 0 0 0 0 0 0 0 0 0 0 0 0
      0 0 0 0 0 0 0 0 0 0 0 0 0 0 0 0 0 0 0 0 0 0 0 0 0 0 0 0 0 0 0 0 0 0 0 0 0 0 0 0 0 0 0 0 0
      0 0 0 0 0 0 0 0 0 0 0 0 0 0 0 0 0 0 0 0 0 0 0 0 0 0 0 0 0 0 0 0 0 0 0 0 0 0 0 0 0 0 0 0 0
      0 0 0 0 0 0 0 0 0 0 0 0 0 0 0 0 0 0 0 0 0 0 0 0 0 0 0 0 0 0 0 0 0 0 0 0 0 0 0 0 0 0 0 0 0
      0 0 0 0 0 0 0 0 0 0 0 0 0 0 0 0 0 0 0 0 0 0 0 0 0 0 0 0 0 0 0 0 0 0 0 0 0 0 0 0 0 0 0 0 0
      0 0 0 0 0 0 0 0 0 0 0 0 0 0 0 0 0 0 0 0 0 0 0 0 0 0 0 0 0 0 0 0 1001 1001 1002 0 0 0 0 0 0 0 0 1002 1002
      0 1001 1001 0 1001 0 0 0 0 0 0 0 0 0 0 0 0 0 0 0 0 0 0 0 0 0 0 0 0 0 0 0 0 0 0 0 0 0 0 0 0 0 0 0 0
      0 0 0 0 0 0 0 0 0 0 0 0 0 0 0 0 0 0 0 0 0 0 0 0 0 0 0 0 0 0 0 0 0 0 0 0 0 0 0 0 0 0 0 0 0
      0 0 0 0 0 0 0 0 0 0 0 0 0 0 0 0 0 0 0 0 0 0 0 0 0 0 0 0 0 0 0 0 0 0 0 0 0 0 0 0 0 0 0 0 0
      0 0 0 0 0 0 0 0 0 0 0 0 0 0 0 0 0 0 0 0 0 0 0 0 0 0 0 0 0 0 0 0 0 0 0 0 0 0 0 0 0 0 0 0 0
      0 0 0 0 0 0 0 0 0 0 0 0 0 0 0 0 0 0 0 0 0 0 0 0 0 0 0 0 0 0 0 0 0 0 0 0 0 0 0 0 0 0 0 0 0
      0 0 0 0 0 0 0 0 0 0 0 0 0 0 0 0 0 0 0 0 0 0 0 0 0 0 0 0 0 0 0 0 0 0 0 0 0 0 0 0 0 0 0 0 0
      2019 2140 2141 2142 2019 2140 2141 2142 2019 2140 2141 2142 2019 2140 2141 2142 2019 2140 2141 2142 2019 2140 2141 2142 2019 2140 2141 2142 2019 2140 2141 2142 2019 2140 2141 2142 2019 2140 2141 2142 2019 2140 2141 2142 2019
      2020 2020 2020 2020 2020 2020 2020 2020 2020 2020 2020 2020 2020 2020 2020 2020 2020 2020 2020 2020 2020 2020 2020 2020 2020 2020 2020 2020 2020 2020 2020 2020 2020 2020 2020 2020 2020 2020 2020 2020 2020 2020 2020 2020 2020
      2020 2020 2020 2020 2020 2020 2020 2020 2020 2020 2020 2020 2020 2020 2020 2020 2020 2020 2020 2020 2020 2020 2020 2020 2020 2020 2020 2020 2020 2020 2020 2020 2020 2020 2020 2020 2020 2020 2020 2020 2020 2020 2020 2020 2020
      2020 2020 2020 2020 2020 2020 2020 2020 2020 2020 2020 2020 2020 2020 2020 2020 2020 2020 2020 2020 2020 2020 2020 2020 2020 2020 2020 2020 2020 2020 2020 2020 2020 2020 2020 2020 2020 2020 2020 2020 2020 2020 2020 2020 2020
      2020 2020 2020 2020 2020 2020 2020 2020 2020 2020 2020 2020 2020 2020 2020 2020 2020 2020 2020 2020 2020 2020 2020 2020 2020 2020 2020 2020 2020 2020 2020 2020 2020 2020 2020 2020 2020 2020 2020 2020 2020 2020 2020 2020 2020
      2020 2020 2020 2020 2020 2020 2020 2020 2020 2020 2020 2020 2020 2020 2020 2020 2020 2020 2020 2020 2020 2020 2020 2020 2020 2020 2020 2020 2020 2020 2020 2020 2020 2020 2020 2020 2020 2020 2020 2020 2020 2020 2020 2020 2020
      2020 2020 2020 2020 2020 2020 2020 2020 2020 2020 2020 2020 2020 2020 2020 2020 2020 2020 2020 2020 2020 2020 2020 2020 2020 2020 2020 2020 2020 2020 2020 2020 2020 2020 2020 2020 2020 2020 2020 2020 2020 2020 2020 2020 2020
      2020 2020 2020 2020 2020 2020 2020 2020 2020 2020 2020 2020 2020 2020 2020 2020 2020 2020 2020 2020 2020 2020 2020 2020 2020 2020 2020 2020 2020 2020 2020 2020 2020 2020 2020 2020 2020 2020 2020 2020 2020 2020 2020 2020 2020
      2020 2020 2020 2020 2020 2020 2020 2020 2020 2020 2020 2020 2020 2020 2020 2020 2020 2020 2020 2020 2020 2020 2020 2020 2020 2020 2020 2020 2020 2020 2020 2020 2020 2020 2020 2020 2020 2020 2020 2020 2020 2020 2020 2020 2020
      )
    )
    (tilemap
      (solid #t)
      (z-pos 0)
      (width 45)
      (height 30)
      (tiles
      0 0 0 0 0 0 0 0 0 0 0 0 0 0 0 0 0 0 0 0 0 0 0 0 0 0 0 0 0 0 0 0 0 0 0 0 0 0 0 0 0 0 0 0 0
      0 0 0 0 0 0 0 0 0 0 0 0 0 0 0 0 0 0 0 0 0 0 0 0 0 0 0 0 0 0 0 0 0 0 0 0 0 0 0 0 0 0 0 0 0
      0 0 0 0 0 0 0 0 0 0 0 0 0 0 0 0 0 0 0 0 0 0 0 0 0 0 0 0 0 0 0 0 0 0 0 0 0 0 0 0 0 0 0 0 0
      0 0 0 0 0 0 0 0 0 0 0 0 0 0 0 0 0 0 0 0 0 0 0 0 0 0 0 0 0 0 0 0 0 0 0 0 0 0 0 0 0 0 0 0 0
      0 0 0 0 0 0 0 0 0 0 0 0 0 0 0 0 0 0 0 0 0 0 0 0 0 0 0 0 0 0 0 0 0 0 0 0 0 0 0 0 0 0 0 0 0
      0 0 0 0 0 0 0 0 0 0 0 0 0 0 0 0 0 0 0 0 0 0 0 0 0 0 0 0 0 0 0 0 0 0 0 0 0 0 0 0 0 0 0 0 0
      0 0 0 0 0 0 0 0 0 0 0 0 0 0 0 0 0 0 0 0 0 0 0 0 0 0 0 0 0 0 0 0 0 0 0 0 0 0 0 0 0 0 0 0 0
      0 0 0 0 0 0 0 0 0 0 0 0 0 0 0 0 0 0 0 0 0 0 0 0 0 0 0 0 0 0 0 0 0 0 0 0 0 0 0 0 0 0 0 0 0
      0 0 0 0 0 0 0 0 0 0 0 0 0 0 0 0 0 0 0 0 0 0 0 0 0 0 0 0 0 0 0 0 0 0 0 0 0 0 0 0 0 0 0 0 0
      0 0 0 0 0 0 0 0 0 0 0 0 0 0 0 0 0 0 0 0 0 0 0 0 0 0 0 0 0 0 0 0 0 0 0 0 0 0 0 0 0 0 0 0 0
      0 0 0 0 0 0 0 0 0 0 0 0 0 0 0 0 0 0 0 0 0 0 0 0 0 0 0 0 0 0 0 0 0 0 0 0 0 0 0 0 0 0 0 0 0
      0 0 0 0 0 0 0 0 0 0 0 0 0 0 0 0 0 0 0 0 0 0 0 0 0 0 0 0 0 0 0 0 0 0 1569 0 0 0 0 0 0 0 0 0 0
      0 0 0 0 0 0 0 0 0 0 0 0 0 0 0 0 0 0 0 0 0 0 0 0 0 0 0 0 0 0 0 0 0 0 1573 0 0 0 0 0 0 0 0 0 0
      0 0 0 0 0 0 0 0 0 0 0 0 0 0 0 0 0 0 0 0 0 0 0 0 0 0 0 0 0 0 0 0 317 318 1573 0 0 0 0 0 0 0 0 317 318
      0 0 0 0 1569 0 0 0 0 0 0 0 0 0 0 0 0 0 0 0 0 0 0 0 0 0 0 0 1000 1001 1001 1002 319 320 1572 1001 1002 1001 1002 1001 1001 1001 1002 319 320
      1001 1002 1001 1002 1572 1002 1001 1002 1001 1001 1002 1001 1002 1001 1002 1003 0 0 0 0 0 0 0 0 0 0 0 0 1004 1005 1005 1006 1005 1006 1006 1005 1006 1005 1006 1005 1005 1005 1006 1005 1006
      1005 1006 1005 1006 1005 1006 1005 1006 1005 1005 1006 1005 1006 1005 1006 1007 0 0 0 0 0 0 0 0 0 0 0 0 1016 1009 1010 1009 1009 1009 1009 1009 1009 1009 1009 1009 1020 1021 1021 1021 1022
      1009 1009 1009 1009 1009 1009 1020 1021 1021 1021 1022 1009 1009 1009 1010 1019 0 0 0 0 0 0 0 0 0 0 0 0 0 3462 3463 1009 1009 1009 1009 1009 1010 1009 1009 1020 1032 1024 1024 1024 1025
      1009 1010 1009 1009 1009 1020 1032 1024 1024 1024 1025 1009 1009 3464 3465 0 0 0 0 0 0 0 0 0 0 0 0 0 0 0 0 3466 1009 1009 1010 1009 1009 1020 1021 1032 1029 1030 1024 1029 1028
      1009 1009 1009 1020 1021 1032 1029 1030 1024 1029 1028 1009 3467 0 0 0 0 0 0 0 0 0 0 0 0 0 0 0 0 0 0 3470 1009 1009 1009 1009 1009 1023 1024 1024 1031 1032 1029 1028 1009
      1009 1009 1009 1023 1024 1024 1031 1032 1029 1028 1009 1009 3471 0 0 0 0 0 0 0 0 0 0 0 0 0 0 0 0 0 0 0 3468 1009 1013 1009 1009 1026 1027 1030 1024 1029 1028 1010 1009
      1009 1009 1009 1026 1027 1030 1024 1029 1028 1009 1009 3469 0 0 0 0 0 0 0 0 0 0 0 0 0 0 0 0 0 0 0 0 0 1008 1009 1009 1010 1009 1009 1023 1024 1025 1009 1009 1009
      1009 1009 1009 1009 1009 1026 1027 1028 1009 1009 1011 0 0 0 0 0 0 0 0 0 0 0 0 0 0 0 0 0 0 0 0 0 0 1012 1013 1009 1009 1009 1020 1032 1024 1031 1022 1009 1009
      1009 1009 1009 1009 1009 1009 1009 1009 1009 1009 1015 0 0 0 0 0 0 0 0 0 0 0 0 0 0 0 0 0 0 0 0 0 0 1008 1009 1009 1009 1020 1032 1024 1024 1024 1025 1009 1009
      1009 1009 1009 1009 1009 1009 1009 1009 1009 1009 1011 0 0 0 0 0 0 0 0 0 0 0 0 0 0 0 0 0 0 0 0 0 0 1012 1013 1020 1021 1032 1029 1030 1024 1029 1028 1009 1009
      1009 1009 1009 1009 1009 1009 1009 1009 1009 1009 1015 0 0 0 0 0 0 0 0 0 0 0 0 0 0 0 0 0 0 0 0 0 0 1008 1009 1023 1024 1024 1031 1032 1029 1028 1009 1010 1009
      1009 1009 1009 1009 1009 1009 1009 1009 1009 1009 1011 0 0 0 0 0 0 0 0 0 0 0 0 0 0 0 0 0 0 0 0 0 0 1012 1013 1026 1027 1030 1024 1029 1028 1009 1009 1009 1009
      1009 1009 1009 1009 1009 1009 1009 1009 1009 1009 1015 0 0 0 0 0 0 0 0 0 0 0 0 0 0 0 0 0 0 0 0 0 0 1008 1009 1009 1009 1026 1027 1028 1009 1009 1009 1009 1009
      1009 1010 1009 1009 1009 1009 1010 1009 1009 1009 1011 0 0 0 0 0 0 0 0 0 0 0 0 0 0 0 0 0 0 0 0 0 0 1012 1013 1010 1009 1009 1009 1009 1009 1009 1009 1009 1009
      1009 1009 1009 1009 1009 1009 1009 1009 1009 1009 1015 0 0 0 0 0 0 0 0 0 0 0 0 0 0 0 0 0 0 0 0 0 0 1008 1009 1009 1009 1009 1013 1009 1009 1009 1010 1009 1009
      )
    )
    (tilemap
      (solid #f)
      (z-pos -150)
      (width 45)
      (height 30)
      (tiles
      0 0 0 0 0 0 0 0 0 0 0 0 0 0 0 0 0 0 0 0 0 0 0 0 0 0 0 0 0 0 0 0 0 0 0 0 0 0 0 0 0 0 0 0 0
      0 0 0 0 0 0 0 0 0 0 0 0 0 0 0 0 0 0 0 0 0 0 0 0 0 0 0 0 0 0 0 0 0 0 0 0 0 0 0 0 0 0 0 0 0
      0 0 0 0 0 0 0 0 0 0 0 0 1240 1241 1242 0 0 0 0 0 0 0 0 0 0 0 0 0 0 0 0 0 0 0 0 0 0 0 0 0 0 0 0 0 0
      0 0 0 0 0 0 0 0 0 0 0 1243 1244 1245 1246 0 0 0 0 0 0 0 0 0 0 0 0 0 0 0 0 1240 1241 1242 0 0 1240 1241 1242 0 0 0 1240 1241 1242
      0 0 0 1240 1241 1242 0 0 0 0 0 1247 1248 1249 1250 0 0 0 0 0 0 0 0 0 0 0 0 0 0 0 1243 1244 1245 1246 0 1243 1244 1245 1246 0 0 1243 1244 1245 1246
      0 0 1243 1244 1245 1246 0 0 0 0 0 1251 1252 1253 1254 0 0 0 0 0 0 0 0 0 0 0 0 0 0 0 1247 1248 1249 1250 0 1247 1248 1249 1250 0 0 1247 1248 1249 1250
      0 0 1247 1248 1249 1250 0 0 0 0 0 1255 1256 1257 1258 0 0 0 0 0 0 0 0 0 0 0 0 0 0 0 1251 1252 1253 1254 0 1251 1252 1253 1254 0 0 1251 1252 1253 1254
      0 0 1251 1252 1253 1254 0 0 0 0 0 1259 1260 1261 1262 0 0 0 0 0 0 0 0 0 0 0 0 0 0 0 1255 1256 1257 1258 0 1255 1256 1257 1258 0 0 1255 1256 1257 1258
      0 0 1255 1256 1257 1258 0 0 0 0 0 1263 1264 1265 1266 0 0 0 0 0 0 0 0 0 0 0 0 0 0 0 1259 1260 1261 1262 0 1259 1260 1261 1262 0 0 1259 1260 1261 1262
      0 0 1259 1260 1261 1262 0 0 0 0 0 1267 1268 1269 1270 0 0 0 0 0 0 0 0 0 0 0 0 0 0 0 1263 1264 1265 1266 0 1263 1264 1265 1266 0 0 1263 1264 1265 1266
      0 0 1263 1264 1265 1266 0 0 0 0 0 0 1272 1273 0 0 0 0 0 0 0 0 0 0 0 0 0 0 0 0 1267 1268 1269 1270 0 1267 1268 1269 1270 0 0 1267 1268 1269 1270
      0 0 1267 1268 1269 1270 0 0 0 0 0 0 1276 1277 0 0 0 0 0 0 0 0 0 0 0 0 0 0 0 0 1271 1272 1273 1274 0 1271 1272 1273 1274 0 0 1271 1272 1273 1274
      0 0 1271 1272 1273 1274 0 0 0 0 0 1271 1272 1273 1274 0 0 0 0 0 0 0 0 0 0 0 0 0 0 0 1275 1276 1277 1278 0 1275 1276 1277 1278 0 0 1275 1276 1277 1278
      0 0 1275 1276 1277 1278 0 0 0 0 0 1275 1276 1277 1278 0 0 0 0 0 0 0 0 0 0 0 0 0 0 0 1279 1280 1281 1282 0 1279 1280 1281 1282 0 0 1279 1280 1281 1282
      0 0 1279 1280 1281 1282 0 0 0 0 0 1279 1280 1281 1282 0 0 0 0 0 0 0 0 0 0 0 0 0 0 0 1283 1284 1285 1286 0 1283 1284 1285 1286 0 0 1283 1284 1285 1286
      0 0 1283 1284 1285 1286 0 0 0 0 0 1283 1284 1285 1286 0 0 0 0 0 0 0 0 0 0 0 0 0 0 0 0 0 0 0 0 0 0 0 0 0 0 1283 0 0 1286
      0 0 0 0 0 0 0 0 0 0 0 0 0 0 0 0 0 0 0 0 0 0 0 0 0 0 0 0 0 0 0 0 0 0 0 0 0 0 0 0 0 0 0 0 0
      0 0 0 0 0 0 0 0 0 0 0 0 0 0 0 0 0 0 0 0 0 0 0 0 0 0 0 0 0 0 0 0 0 0 0 0 0 0 0 0 0 0 0 0 0
      0 0 0 0 0 0 0 0 0 0 0 0 0 0 0 0 0 0 0 0 0 0 0 0 0 0 0 0 0 0 0 0 0 0 0 0 0 0 0 0 0 0 0 0 0
      0 0 0 0 0 0 0 0 0 0 0 0 0 0 0 0 0 0 0 0 0 0 0 0 0 0 0 0 0 0 0 0 0 0 0 0 0 0 0 0 0 0 0 0 0
      0 0 0 0 0 0 0 0 0 0 0 0 0 0 0 0 0 0 0 0 0 0 0 0 0 0 0 0 0 0 0 0 0 0 0 0 0 0 0 0 0 0 0 0 0
      0 0 0 0 0 0 0 0 0 0 0 0 0 0 0 0 0 0 0 0 0 0 0 0 0 0 0 0 0 0 0 0 0 0 0 0 0 0 0 0 0 0 0 0 0
      0 0 0 0 0 0 0 0 0 0 0 0 0 0 0 0 0 0 0 0 0 0 0 0 0 0 0 0 0 0 0 0 0 0 0 0 0 0 0 0 0 0 0 0 0
      0 0 0 0 0 0 0 0 0 0 0 0 0 0 0 0 0 0 0 0 0 0 0 0 0 0 0 0 0 0 0 0 0 0 0 0 0 0 0 0 0 0 0 0 0
      0 0 0 0 0 0 0 0 0 0 0 0 0 0 0 0 0 0 0 0 0 0 0 0 0 0 0 0 0 0 0 0 0 0 0 0 0 0 0 0 0 0 0 0 0
      0 0 0 0 0 0 0 0 0 0 0 0 0 0 0 0 0 0 0 0 0 0 0 0 0 0 0 0 0 0 0 0 0 0 0 0 0 0 0 0 0 0 0 0 0
      0 0 0 0 0 0 0 0 0 0 0 0 0 0 0 0 0 0 0 0 0 0 0 0 0 0 0 0 0 0 0 0 0 0 0 0 0 0 0 0 0 0 0 0 0
      0 0 0 0 0 0 0 0 0 0 0 0 0 0 0 0 0 0 0 0 0 0 0 0 0 0 0 0 0 0 0 0 0 0 0 0 0 0 0 0 0 0 0 0 0
      0 0 0 0 0 0 0 0 0 0 0 0 0 0 0 0 0 0 0 0 0 0 0 0 0 0 0 0 0 0 0 0 0 0 0 0 0 0 0 0 0 0 0 0 0
      0 0 0 0 0 0 0 0 0 0 0 0 0 0 0 0 0 0 0 0 0 0 0 0 0 0 0 0 0 0 0 0 0 0 0 0 0 0 0 0 0 0 0 0 0
      )
    )
    (walkingleaf
      (direction "left")
      (x 960)
      (y 384)
    )
  )
)
