(supertux-level
  (version 2)
  (name (_ "  The Shop  "))
  (author "LMH")
  (license "GPL 2 / CC-by-sa 3.0")
  (sector
    (name "main")
    (init-script "  show_shop_rewards();  ")
    (ambient-light
      (color 1 1 1)
    )
    (bonusblock
      (custom-contents
         (powerup           (sprite "images/powerups/egg/egg.sprite")
           (script "  buy_powerup(\"egg\");  ")
)
      )
      (script "")
      (contents "custom")
      (x 624)
      (y 576)
    )
    (bonusblock
      (custom-contents
         (powerup           (sprite "images/powerups/iceflower/iceflower.sprite")
           (script "  buy_powerup(\"ice\");  ")
)
      )
      (script "")
      (contents "custom")
      (x 816)
      (y 576)
    )
    (bonusblock
      (custom-contents
         (powerup           (sprite "images/powerups/fireflower/fireflower.sprite")
           (script "  buy_powerup(\"fire\");  ")
)
      )
      (script "")
      (contents "custom")
      (x 1008)
      (y 576)
    )
    (camera
      (mode "normal")
    )
    (gradient
      (top_color 0.5 0 0.5)
      (bottom_color 0 0 0)
    )
    (infoblock
      (message (_ "-Welcome to The Shop
#Completing level statistics in the regular levels will allow you to purchase powerups here to aid in your journey."))
      (x 224)
      (y 576)
    )
    (infoblock
      (message (_ "-Progress Poles
#Your progress in collecting coins, killing enemies, and speedy completion is tracked on the poles to your left.  Each dot represents a level starting with level 1 at the bottom.  Dots turn green when progress is completed."))
      (x 560)
      (y 352)
    )
    (infoblock
      (message (_ "-Powerups for Purchase
#Below are the powerups currently available for purchase.  As more progress is completed, powerups become available from left to right."))
      (x 752)
      (y 352)
    )
    (infoblock
      (message (_ "-Star Stones
#Finding all three star stones will allow you to gain Ultimate Invulnerability.  This ability will be activated and deactivated by placing the stones on the ledge to your right."))
      (x 944)
      (y 352)
    )
    (infoblock
      (message (_ "*Tier 1 Reward
#Purchase an egg for 50 coins"))
      (x 560)
      (y 576)
    )
    (infoblock
      (message (_ "*Tier 2 Reward
#Purchase a 2x iceflower for 200 coins"))
      (x 752)
      (y 576)
    )
    (infoblock
      (message (_ "*Tier 3 Reward
#Purchase a 3x fireflower for 600 coins"))
      (x 944)
      (y 576)
    )
    (infoblock
      (message (_ "*---WARNING!---
#Pressing this button will reset all your progress.
-DO NOT PUSH"))
      (x 224)
      (y 352)
    )
    (music
      (file "music/bonuscave.ogg")
    )
    (path
      (name "fa6205d2-7576-4580-8c23-24ece52d5025")
      (path
        (node
          (x 128)
          (y 224)
        )
      )
    )
    (path
      (name "e0f06d3b-ddc1-45cc-8f07-49ef6cbfda39")
      (path
        (node
          (x 608)
          (y 560)
        )
      )
    )
    (path
      (name "4cbfcbed-9b04-4230-9de9-b6b70fa68dd2")
      (path
        (node
          (x 800)
          (y 560)
        )
      )
    )
    (path
      (name "07ea0515-bf56-4c90-b102-a488da6d3192")
      (path
        (node
          (x 992)
          (y 560)
        )
      )
    )
    (pushbutton
      (script "  delete_progress();
        show_shop_rewards();  ")
      (x 160)
      (y 448)
    )
    (scriptedobject
      (z-pos 50)
      (physic-enabled #f)
      (solid #f)
      (name "COIN")
      (sprite "images/objects/coin/coin.sprite")
      (x 320)
      (y 288)
    )
    (scriptedobject
      (z-pos 50)
      (physic-enabled #f)
      (solid #f)
      (name "KILL")
      (sprite "images/creatures/mr_iceblock/mr_iceblock.sprite")
      (x 384)
      (y 288)
    )
    (scriptedobject
      (z-pos 50)
      (physic-enabled #f)
      (solid #f)
      (name "TIME")
      (sprite "levels/mattie_world/images/LMH/time.sprite")
      (x 448)
      (y 288)
    )
    (scriptedobject
      (z-pos 50)
      (physic-enabled #f)
      (solid #f)
      (name "coin1")
      (sprite "images/worldmap/common/leveldot.sprite")
      (x 337)
      (y 688)
    )
    (scriptedobject
      (z-pos 50)
      (physic-enabled #f)
      (solid #f)
      (name "coin2")
      (sprite "images/worldmap/common/leveldot.sprite")
      (x 337)
      (y 656)
    )
    (scriptedobject
      (z-pos 50)
      (physic-enabled #f)
      (solid #f)
      (name "coin3")
      (sprite "images/worldmap/common/leveldot.sprite")
      (x 337)
      (y 624)
    )
    (scriptedobject
      (z-pos 50)
      (physic-enabled #f)
      (solid #f)
      (name "coin4")
      (sprite "images/worldmap/common/leveldot.sprite")
      (x 337)
      (y 592)
    )
    (scriptedobject
      (z-pos 50)
      (physic-enabled #f)
      (solid #f)
      (name "coin5")
      (sprite "images/worldmap/common/leveldot.sprite")
      (x 337)
      (y 560)
    )
    (scriptedobject
      (z-pos 50)
      (physic-enabled #f)
      (solid #f)
      (name "coin6")
      (sprite "images/worldmap/common/leveldot.sprite")
      (x 337)
      (y 528)
    )
    (scriptedobject
      (z-pos 50)
      (physic-enabled #f)
      (solid #f)
      (name "coin7")
      (sprite "images/worldmap/common/leveldot.sprite")
      (x 337)
      (y 496)
    )
    (scriptedobject
      (z-pos 50)
      (physic-enabled #f)
      (solid #f)
      (name "coin8")
      (sprite "images/worldmap/common/leveldot.sprite")
      (x 337)
      (y 464)
    )
    (scriptedobject
      (z-pos 50)
      (physic-enabled #f)
      (solid #f)
      (name "coin9")
      (sprite "images/worldmap/common/leveldot.sprite")
      (x 337)
      (y 432)
    )
    (scriptedobject
      (z-pos 50)
      (physic-enabled #f)
      (solid #f)
      (name "coin10")
      (sprite "images/worldmap/common/leveldot.sprite")
      (x 337)
      (y 400)
    )
    (scriptedobject
      (z-pos 50)
      (physic-enabled #f)
      (solid #f)
      (name "coin11")
      (sprite "images/worldmap/common/leveldot.sprite")
      (x 337)
      (y 368)
    )
    (scriptedobject
      (z-pos 50)
      (physic-enabled #f)
      (solid #f)
      (name "coin12")
      (sprite "images/worldmap/common/leveldot.sprite")
      (x 337)
      (y 336)
    )
    (scriptedobject
      (z-pos 50)
      (physic-enabled #f)
      (solid #f)
      (name "kill1")
      (sprite "images/worldmap/common/leveldot.sprite")
      (x 401)
      (y 688)
    )
    (scriptedobject
      (z-pos 50)
      (physic-enabled #f)
      (solid #f)
      (name "kill2")
      (sprite "images/worldmap/common/leveldot.sprite")
      (x 401)
      (y 656)
    )
    (scriptedobject
      (z-pos 50)
      (physic-enabled #f)
      (solid #f)
      (name "kill3")
      (sprite "images/worldmap/common/leveldot.sprite")
      (x 401)
      (y 624)
    )
    (scriptedobject
      (z-pos 50)
      (physic-enabled #f)
      (solid #f)
      (name "kill4")
      (sprite "images/worldmap/common/leveldot.sprite")
      (x 401)
      (y 592)
    )
    (scriptedobject
      (z-pos 50)
      (physic-enabled #f)
      (solid #f)
      (name "kill5")
      (sprite "images/worldmap/common/leveldot.sprite")
      (x 401)
      (y 560)
    )
    (scriptedobject
      (z-pos 50)
      (physic-enabled #f)
      (solid #f)
      (name "kill6")
      (sprite "images/worldmap/common/leveldot.sprite")
      (x 401)
      (y 528)
    )
    (scriptedobject
      (z-pos 50)
      (physic-enabled #f)
      (solid #f)
      (name "kill7")
      (sprite "images/worldmap/common/leveldot.sprite")
      (x 401)
      (y 496)
    )
    (scriptedobject
      (z-pos 50)
      (physic-enabled #f)
      (solid #f)
      (name "kill8")
      (sprite "images/worldmap/common/leveldot.sprite")
      (x 401)
      (y 464)
    )
    (scriptedobject
      (z-pos 50)
      (physic-enabled #f)
      (solid #f)
      (name "kill9")
      (sprite "images/worldmap/common/leveldot.sprite")
      (x 401)
      (y 432)
    )
    (scriptedobject
      (z-pos 50)
      (physic-enabled #f)
      (solid #f)
      (name "kill10")
      (sprite "images/worldmap/common/leveldot.sprite")
      (x 401)
      (y 400)
    )
    (scriptedobject
      (z-pos 50)
      (physic-enabled #f)
      (solid #f)
      (name "kill11")
      (sprite "images/worldmap/common/leveldot.sprite")
      (x 401)
      (y 368)
    )
    (scriptedobject
      (z-pos 50)
      (physic-enabled #f)
      (solid #f)
      (name "kill12")
      (sprite "images/worldmap/common/leveldot.sprite")
      (x 401)
      (y 336)
    )
    (scriptedobject
      (z-pos 50)
      (physic-enabled #f)
      (solid #f)
      (name "time1")
      (sprite "images/worldmap/common/leveldot.sprite")
      (x 465)
      (y 688)
    )
    (scriptedobject
      (z-pos 50)
      (physic-enabled #f)
      (solid #f)
      (name "time2")
      (sprite "images/worldmap/common/leveldot.sprite")
      (x 465)
      (y 656)
    )
    (scriptedobject
      (z-pos 50)
      (physic-enabled #f)
      (solid #f)
      (name "time3")
      (sprite "images/worldmap/common/leveldot.sprite")
      (x 465)
      (y 624)
    )
    (scriptedobject
      (z-pos 50)
      (physic-enabled #f)
      (solid #f)
      (name "time4")
      (sprite "images/worldmap/common/leveldot.sprite")
      (x 465)
      (y 592)
    )
    (scriptedobject
      (z-pos 50)
      (physic-enabled #f)
      (solid #f)
      (name "time5")
      (sprite "images/worldmap/common/leveldot.sprite")
      (x 465)
      (y 560)
    )
    (scriptedobject
      (z-pos 50)
      (physic-enabled #f)
      (solid #f)
      (name "time6")
      (sprite "images/worldmap/common/leveldot.sprite")
      (x 465)
      (y 528)
    )
    (scriptedobject
      (z-pos 50)
      (physic-enabled #f)
      (solid #f)
      (name "time7")
      (sprite "images/worldmap/common/leveldot.sprite")
      (x 465)
      (y 496)
    )
    (scriptedobject
      (z-pos 50)
      (physic-enabled #f)
      (solid #f)
      (name "time8")
      (sprite "images/worldmap/common/leveldot.sprite")
      (x 465)
      (y 464)
    )
    (scriptedobject
      (z-pos 50)
      (physic-enabled #f)
      (solid #f)
      (name "time9")
      (sprite "images/worldmap/common/leveldot.sprite")
      (x 465)
      (y 432)
    )
    (scriptedobject
      (z-pos 50)
      (physic-enabled #f)
      (solid #f)
      (name "time10")
      (sprite "images/worldmap/common/leveldot.sprite")
      (x 465)
      (y 400)
    )
    (scriptedobject
      (z-pos 50)
      (physic-enabled #f)
      (solid #f)
      (name "time11")
      (sprite "images/worldmap/common/leveldot.sprite")
      (x 465)
      (y 368)
    )
    (scriptedobject
      (z-pos 50)
      (physic-enabled #f)
      (solid #f)
      (name "time12")
      (sprite "images/worldmap/common/leveldot.sprite")
      (x 465)
      (y 336)
    )
    (scriptedobject
      (z-pos 50)
      (visible #f)
      (physic-enabled #f)
      (solid #f)
      (name "EARTH")
      (sprite "levels/mattie_world/images/powerups/crystal/green_crystal.sprite")
      (x 1130)
      (y 576)
    )
    (scriptedobject
      (z-pos 50)
      (visible #f)
      (physic-enabled #f)
      (solid #f)
      (name "AIR")
      (sprite "levels/mattie_world/images/powerups/crystal/green_crystal.sprite")
      (x 1152)
      (y 563)
    )
    (scriptedobject
      (z-pos 50)
      (visible #f)
      (physic-enabled #f)
      (solid #f)
      (name "FIRE")
      (sprite "levels/mattie_world/images/powerups/crystal/green_crystal.sprite")
      (x 1175)
      (y 576)
    )
    (scriptedobject
      (z-pos 50)
      (visible #f)
      (physic-enabled #f)
      (solid #f)
      (name "STAR")
      (sprite "images/powerups/star/star.sprite")
      (x 1152)
      (y 416)
    )
    (scripttrigger
      (script "  Level.finish(false);  ")
      (button #f)
      (width 16)
      (height 64)
      (x 32)
      (y 640)
    )
    (scripttrigger
      (script "  reveal_crystal(\"earthcrystal\");  ")
      (button #f)
      (width 16)
      (height 32)
      (x 1138)
      (y 560)
    )
    (scripttrigger
      (script "  reveal_crystal(\"aircrystal\");  ")
      (button #f)
      (width 16)
      (height 32)
      (x 1160)
      (y 560)
    )
    (scripttrigger
      (script "  reveal_crystal(\"firecrystal\");  ")
      (button #f)
      (width 16)
      (height 32)
      (x 1183)
      (y 560)
    )
    (scripttrigger
      (script "  toggle_star_bonus()  ")
      (button #f)
      (width 64)
      (height 64)
      (x 1136)
      (y 544)
    )
    (scripttrigger
      (script "  reset.fade(0,1);  ")
      (button #f)
      (width 16)
      (height 192)
      (x 288)
      (y 272)
    )
    (spawnpoint
      (name "main")
      (x 160)
      (y 640)
    )
    (tilemap
      (solid #t)
      (z-pos 0)
      (name "interactive")
      (width 40)
      (height 25)
      (tiles
      131 131 131 131 131 131 131 131 131 131 131 131 131 131 131 131 131 131 131 131 131 131 131 131 131 131 131 131 131 131 131 131 131 131 131 131 131 131 131 131
      131 131 131 131 131 131 131 131 131 131 131 131 131 131 131 131 131 131 131 131 131 131 131 131 131 131 131 131 131 131 131 131 131 131 131 131 131 131 131 131
      131 131 131 131 131 131 131 131 131 131 131 131 131 131 131 131 131 131 131 131 131 131 131 131 131 131 131 131 131 131 131 131 131 131 131 131 131 131 131 131
      131 131 131 131 131 131 131 131 131 131 131 131 131 131 131 131 131 131 131 131 131 131 131 131 131 131 131 131 131 131 131 131 131 131 131 131 131 131 131 131
      131 131 131 131 131 131 131 131 131 131 131 1400 1379 1379 1379 1379 1379 1379 1379 1379 1379 1379 1379 1379 1379 1379 1379 1379 1379 1379 1379 1392 131 131 131 131 131 131 131 131
      131 131 131 131 131 131 131 131 1400 1379 1379 1371 1406 1376 1376 1376 1376 1376 1376 1376 1376 1376 1376 1376 1376 1376 1376 1376 1376 1376 1394 1383 1379 1379 1392 131 131 131 131 131
      131 131 131 131 131 131 1400 1379 1371 1406 1376 1376 1399 0 0 0 0 0 0 0 0 0 0 0 0 0 0 0 0 0 1374 1376 1376 1394 1383 1379 1392 131 131 131
      131 131 131 131 131 1400 1371 1406 1376 1399 0 0 0 0 0 0 0 0 0 0 0 0 0 0 0 0 0 0 0 0 0 0 0 1374 1376 1394 1383 1392 131 131
      131 131 131 131 1400 1371 1406 1399 0 0 0 0 0 0 0 0 0 0 0 0 0 0 0 0 0 0 0 0 0 0 0 0 0 0 0 1374 1394 1383 1392 131
      131 131 131 1400 1371 1406 1399 0 0 0 0 0 0 0 0 0 0 0 0 0 0 0 0 0 0 0 0 0 0 0 0 0 0 0 0 0 1374 1394 1373 131
      131 131 131 1404 1406 1399 0 0 0 0 0 0 0 0 0 0 0 0 0 0 0 0 0 0 0 0 0 0 0 0 0 0 0 0 0 0 0 1404 1383 1392
      131 131 131 1404 1373 0 0 0 0 0 0 0 0 0 0 0 0 0 0 0 0 0 0 0 0 0 0 0 0 0 0 0 0 0 0 0 0 1374 1394 1373
      131 131 131 1404 1373 0 0 0 0 0 0 0 0 0 0 0 0 0 0 0 0 0 0 0 0 0 0 0 0 0 0 0 0 0 0 0 0 0 1404 1373
      131 131 131 1404 1373 0 0 0 0 0 0 0 0 0 0 0 0 0 0 0 0 0 0 0 0 0 0 0 0 0 0 0 0 0 0 0 0 0 1404 1373
      131 131 131 1404 1373 48 0 0 0 0 0 0 0 0 0 0 0 0 0 0 0 0 0 0 0 0 0 0 0 0 0 0 0 0 0 0 0 0 1404 1373
      131 131 131 1404 1381 1412 1412 1412 1388 0 0 0 0 0 0 2817 2817 2817 2817 2817 2817 2817 2817 2817 2817 2817 2817 2817 2817 2817 2817 2817 2817 0 0 0 0 0 1404 1373
      131 131 131 1404 1373 0 0 0 0 0 0 0 0 0 0 0 0 0 0 0 0 0 0 0 0 0 0 0 0 0 0 0 0 0 0 0 0 0 1404 1373
      131 131 131 1404 1373 0 0 0 0 0 0 0 0 0 0 0 0 0 0 0 0 0 0 0 0 0 0 0 0 0 0 0 0 0 0 0 0 0 1404 1373
      131 1400 1379 1371 1373 0 0 0 0 0 0 0 0 0 0 0 0 0 0 0 0 0 0 0 0 0 0 0 0 0 0 0 0 0 0 0 0 0 1404 1373
      131 1374 1376 1376 1399 0 0 0 0 0 0 0 0 0 0 0 0 0 0 0 0 0 0 0 0 0 0 0 0 0 0 0 0 0 0 1400 1379 1379 1371 1373
      131 131 0 0 0 0 0 0 0 0 0 0 0 0 0 0 0 0 0 0 0 0 0 0 0 0 0 0 0 0 0 0 0 0 0 1404 1372 1372 1372 1373
      131 131 0 0 0 0 0 0 0 0 0 0 0 0 0 0 0 0 0 0 0 0 0 0 0 0 0 0 0 0 0 0 0 0 0 1404 1372 1372 1372 1373
      131 1400 1379 1379 1379 1379 1379 1379 1379 1379 1379 1379 1379 1379 1379 1379 1379 1379 1379 1379 1379 1379 1379 1379 1379 1379 1379 1379 1379 1379 1379 1379 1379 1379 1379 1371 1372 1372 1372 1373
      131 1404 1372 1372 1372 1372 1372 1372 1372 1372 1372 1372 1372 1372 1372 1372 1372 1372 1372 1372 1372 1372 1372 1372 1372 1372 1372 1372 1372 1372 1372 1372 1372 1372 1372 1372 1372 1372 1372 1373
      131 1374 1376 1376 1376 1376 1376 1376 1376 1376 1376 1376 1376 1376 1376 1376 1376 1376 1376 1376 1376 1376 1376 1376 1376 1376 1376 1376 1376 1376 1376 1376 1376 1376 1376 1376 1376 1376 1376 1399
      )
    )
    (tilemap
      (solid #f)
      (z-pos -100)
      (name "background")
      (width 40)
      (height 25)
      (tiles
      131 131 131 131 131 131 131 131 131 131 131 131 131 131 131 131 131 131 131 131 131 131 131 131 131 131 131 131 131 131 131 131 131 131 131 131 131 131 131 131
      131 131 131 131 131 131 131 131 131 131 131 131 131 131 131 131 131 131 131 131 131 131 131 131 131 131 131 131 131 131 131 131 131 131 131 131 131 131 131 131
      131 131 131 131 131 131 131 131 131 131 131 131 131 131 131 131 131 131 131 131 131 131 131 131 131 131 131 131 131 131 131 131 131 131 131 131 131 131 131 131
      131 131 131 131 131 131 131 131 131 131 131 131 131 131 131 131 131 131 131 131 131 131 131 131 131 131 131 131 131 131 131 131 131 131 131 131 131 131 131 131
      131 131 131 131 131 131 131 131 131 131 131 131 131 131 131 131 131 131 131 131 131 131 131 131 131 131 131 131 131 131 131 131 131 131 131 131 131 131 131 131
      131 131 131 131 131 131 131 131 131 131 131 131 0 0 0 0 0 0 0 0 0 0 0 0 0 0 0 0 0 0 0 131 131 131 131 131 131 131 131 131
      131 131 131 131 131 131 131 131 131 0 0 0 0 0 0 0 0 0 0 0 0 0 0 0 0 0 0 0 0 0 0 0 0 0 131 131 131 131 131 131
      131 131 131 131 131 131 131 0 0 0 0 0 0 0 0 0 0 0 0 0 0 0 0 0 0 0 0 0 0 0 0 0 0 0 0 0 131 131 131 131
      131 131 131 131 131 131 0 0 0 0 80 0 80 0 80 0 0 0 0 0 0 0 0 0 0 0 0 0 0 0 0 0 0 0 0 0 0 131 131 131
      131 131 131 131 131 0 0 0 0 0 79 0 79 0 79 0 0 0 0 0 0 0 0 0 0 0 0 0 0 0 0 0 0 0 0 0 0 0 131 131
      131 131 131 131 0 0 0 0 0 0 79 0 79 0 79 0 0 0 0 0 0 0 0 0 0 0 0 0 0 0 0 0 0 0 0 0 0 0 131 131
      131 131 131 131 0 0 0 0 0 0 79 0 79 0 79 0 0 0 0 0 0 0 0 0 0 0 0 0 0 0 0 0 0 0 0 0 0 0 0 131
      131 131 131 131 0 0 0 0 0 0 79 0 79 0 79 0 0 0 0 0 0 0 0 0 0 0 0 0 0 0 0 0 0 0 0 0 0 0 0 131
      131 131 131 131 0 0 0 1628 1629 0 79 0 79 0 79 0 0 0 0 0 0 0 0 0 0 0 0 0 0 0 0 0 0 0 0 0 0 0 0 131
      131 131 131 131 0 0 0 1630 1631 0 79 0 79 0 79 0 0 0 0 0 0 0 0 0 0 0 0 0 0 0 0 0 0 0 0 0 0 0 0 131
      131 131 131 131 0 0 0 0 0 0 79 0 79 0 79 1408 1412 1412 1412 1412 1412 1412 1412 1412 1412 1412 1412 1412 1412 1412 1412 1412 1388 0 0 0 0 0 0 131
      131 131 131 131 0 0 0 0 0 0 79 0 79 0 79 0 0 0 0 0 0 0 0 0 0 0 0 0 0 0 0 0 0 0 0 0 0 0 0 131
      131 131 131 131 0 0 0 0 0 0 79 0 79 0 79 0 0 0 0 0 0 0 0 0 0 0 0 0 0 0 0 0 0 0 0 0 0 0 0 131
      131 131 131 131 0 0 0 0 0 0 79 0 79 0 79 0 0 0 0 0 0 0 0 0 0 0 0 0 0 0 0 0 0 0 0 0 0 0 0 131
      131 131 0 0 0 0 0 0 0 0 79 0 79 0 79 0 0 0 0 0 0 0 0 0 0 0 0 0 0 0 0 0 0 0 0 0 0 0 0 131
      131 131 0 0 0 0 0 0 0 0 79 0 79 0 79 0 0 0 0 0 0 0 0 0 0 0 0 0 0 0 0 0 0 0 0 0 0 0 0 131
      131 131 0 0 0 0 0 0 0 0 79 0 79 0 79 0 0 0 0 0 0 0 0 0 0 0 0 0 0 0 0 0 0 0 0 0 0 0 0 131
      131 131 0 0 0 0 0 0 0 0 0 0 0 0 0 0 0 0 0 0 0 0 0 0 0 0 0 0 0 0 0 0 0 0 0 0 0 0 0 131
      131 131 0 0 0 0 0 0 0 0 0 0 0 0 0 0 0 0 0 0 0 0 0 0 0 0 0 0 0 0 0 0 0 0 0 0 0 0 0 131
      131 131 131 131 131 131 131 131 131 131 131 131 131 131 131 131 131 131 131 131 131 131 131 131 131 131 131 131 131 131 131 131 131 131 131 131 131 131 131 131
      )
    )
    (tilemap
      (solid #t)
      (z-pos 100)
      (name "reset")
      (path-ref "fa6205d2-7576-4580-8c23-24ece52d5025")
      (width 6)
      (height 9)
      (tiles
      131 1400 1371 1372 1372 1373
      1400 1371 1372 1372 1372 1373
      1371 1372 1372 1372 1372 1373
      1372 1372 1372 1372 1372 1373
      1372 1372 1372 1372 1372 1373
      1372 1372 1372 1372 1372 1373
      1372 1372 1372 1372 1372 1373
      1372 1372 1372 1372 1372 1373
      1406 1376 1376 1376 1376 1399
      )
    )
    (tilemap
      (solid #t)
      (z-pos 100)
      (name "ONE")
      (path-ref "e0f06d3b-ddc1-45cc-8f07-49ef6cbfda39")
      (width 2)
      (height 2)
      (tiles
      1400 1392
      1374 1399
      )
    )
    (tilemap
      (solid #t)
      (z-pos 100)
      (name "TWO")
      (path-ref "4cbfcbed-9b04-4230-9de9-b6b70fa68dd2")
      (width 2)
      (height 2)
      (tiles
      1400 1392
      1374 1399
      )
    )
    (tilemap
      (solid #t)
      (z-pos 100)
      (name "THREE")
      (path-ref "07ea0515-bf56-4c90-b102-a488da6d3192")
      (width 2)
      (height 2)
      (tiles
      1400 1392
      1374 1399
      )
    )
  )
)
