(supertux-level
  (version 2)
  (name (_ "Bonus Level: Skellington Arena"))
  (author "LMH")
  (license "GPL 2 / CC-by-sa 3.0")
  (sector
    (name "main")
    (init-script "  gate <- true;
      cage <- true;
      hidden <- true;
      discover(\"Arena\");  ")
    (ambient-light
      (color 1 1 1)
    )
    (background
      (speed 0.5)
      (image "images/background/semi_arctic.jpg")
    )
    (camera
      (mode "normal")
    )
    (music
      (file "music/chipdisko.ogg")
    )
    (path
      (name "f6092e40-b202-40dd-a6d1-7f71bc618934")
      (path
        (node
          (x 288)
          (y 352)
          (time 0.5)
        )
        (node
          (x 288)
          (y 384)
          (time 3)
        )
        (node
          (x 256)
          (y 384)
          (time 2)
        )
      )
    )
    (path
      (name "93338f66-b1da-40c9-b1cd-4d7a1cf19fa7")
      (path
        (node
          (x 320)
          (y 352)
          (time 0.5)
        )
        (node
          (x 320)
          (y 416)
          (time 3)
        )
        (node
          (x 256)
          (y 416)
          (time 2)
        )
      )
    )
    (path
      (name "8131e784-7b25-4fb7-83d5-13748c24f2e1")
      (path
        (node
          (x 352)
          (y 352)
          (time 0.5)
        )
        (node
          (x 352)
          (y 448)
          (time 3)
        )
        (node
          (x 256)
          (y 448)
          (time 2)
        )
      )
    )
    (path
      (name "74866082-f93d-4690-9e86-caa65c7cd8dd")
      (path
        (node
          (x 384)
          (y 352)
          (time 0.5)
        )
        (node
          (x 384)
          (y 480)
          (time 3)
        )
        (node
          (x 256)
          (y 480)
          (time 2)
        )
      )
    )
    (path
      (name "01c30779-1ec8-480a-bd3c-202069e01ec6")
      (path
        (node
          (x 512)
          (y 352)
          (time 0.5)
        )
        (node
          (x 512)
          (y 384)
          (time 3)
        )
        (node
          (x 544)
          (y 384)
          (time 2)
        )
      )
    )
    (path
      (name "92468da5-4e1d-4b53-ae6b-63f8669e3228")
      (path
        (node
          (x 480)
          (y 352)
          (time 0.5)
        )
        (node
          (x 480)
          (y 416)
          (time 3)
        )
        (node
          (x 544)
          (y 416)
          (time 2)
        )
      )
    )
    (path
      (name "fc8153ae-d89a-4955-8505-6804f0e53dda")
      (path
        (node
          (x 448)
          (y 352)
          (time 0.5)
        )
        (node
          (x 448)
          (y 448)
          (time 3)
        )
        (node
          (x 544)
          (y 448)
          (time 2)
        )
      )
    )
    (path
      (name "ba4c44a7-17c4-48e0-8ba7-2f8e62222a32")
      (path
        (node
          (x 416)
          (y 352)
          (time 0.5)
        )
        (node
          (x 416)
          (y 480)
          (time 3)
        )
        (node
          (x 544)
          (y 480)
          (time 2)
        )
      )
    )
    (path
      (name "4e2ff57c-d250-4d15-8c8a-bba770ae2d0f")
      (path
        (node
          (x 768)
          (y 608)
          (time 2)
        )
        (node
          (x 768)
          (y 480)
          (time 2)
        )
      )
    )
    (path
      (name "3fdd55bf-783c-4d77-ba73-5e31a490a647")
      (path
        (node
          (x 768)
          (y 768)
          (time 4)
        )
        (node
          (x 768)
          (y 1120)
          (time 4)
        )
      )
    )
    (path
      (name "fd5ef9d5-8937-4e2c-86db-0c7872193e15")
      (path
        (node
          (x 768)
          (y 928)
          (time 2)
        )
        (node
          (x 768)
          (y 1120)
          (time 2)
        )
      )
    )
    (path
      (name "e140fcbf-56bd-4318-942a-3d0b9b083160")
      (path
        (node
          (x 192)
          (y 768)
          (time 4)
        )
        (node
          (x 192)
          (y 1120)
          (time 4)
        )
      )
    )
    (path
      (name "65219b96-552e-468c-ad86-d9ea65b6aa6b")
      (path
        (node
          (x 608)
          (y 768)
          (time 4)
        )
        (node
          (x 608)
          (y 1120)
          (time 4)
        )
      )
    )
    (path
      (name "4599be06-7e8f-4d12-87f7-9308c9bcaf4a")
      (path
        (node
          (x 192)
          (y 928)
          (time 2)
        )
        (node
          (x 192)
          (y 1120)
          (time 2)
        )
      )
    )
    (path
      (name "c0314d35-6a2d-4e9f-994c-9458ae002357")
      (path
        (node
          (x 608)
          (y 928)
          (time 2)
        )
        (node
          (x 608)
          (y 1120)
          (time 2)
        )
      )
    )
    (path
      (name "b6d03331-f955-49a9-9342-62a736800e9b")
      (path
        (node
          (x 160)
          (y 608)
          (time 2)
        )
        (node
          (x 160)
          (y 480)
          (time 2)
        )
      )
    )
    (path
      (name "e8122dc9-2773-457d-baa8-0d6a21c720b3")
      (path
        (node
          (x 640)
          (y 608)
          (time 2)
        )
        (node
          (x 640)
          (y 480)
          (time 2)
        )
      )
    )
    (platform
      (running #f)
      (name "dropL1")
      (path-ref "f6092e40-b202-40dd-a6d1-7f71bc618934")
      (sprite "images/objects/platforms/wood-tiny.sprite")
    )
    (platform
      (running #f)
      (name "dropL2")
      (path-ref "93338f66-b1da-40c9-b1cd-4d7a1cf19fa7")
      (sprite "images/objects/platforms/wood-tiny.sprite")
    )
    (platform
      (running #f)
      (name "dropL3")
      (path-ref "8131e784-7b25-4fb7-83d5-13748c24f2e1")
      (sprite "images/objects/platforms/wood-tiny.sprite")
    )
    (platform
      (running #f)
      (name "dropL4")
      (path-ref "74866082-f93d-4690-9e86-caa65c7cd8dd")
      (sprite "images/objects/platforms/wood-tiny.sprite")
    )
    (platform
      (running #f)
      (name "dropR1")
      (path-ref "01c30779-1ec8-480a-bd3c-202069e01ec6")
      (sprite "images/objects/platforms/wood-tiny.sprite")
    )
    (platform
      (running #f)
      (name "dropR2")
      (path-ref "92468da5-4e1d-4b53-ae6b-63f8669e3228")
      (sprite "images/objects/platforms/wood-tiny.sprite")
    )
    (platform
      (running #f)
      (name "dropR3")
      (path-ref "fc8153ae-d89a-4955-8505-6804f0e53dda")
      (sprite "images/objects/platforms/wood-tiny.sprite")
    )
    (platform
      (running #f)
      (name "dropR4")
      (path-ref "ba4c44a7-17c4-48e0-8ba7-2f8e62222a32")
      (sprite "images/objects/platforms/wood-tiny.sprite")
    )
    (platform
      (running #f)
      (name "holdtop")
      (path-ref "4e2ff57c-d250-4d15-8c8a-bba770ae2d0f")
      (sprite "images/objects/platforms/vertical-wood.sprite")
    )
    (platform
      (running #f)
      (name "holdmid")
      (path-ref "3fdd55bf-783c-4d77-ba73-5e31a490a647")
      (sprite "images/objects/platforms/vertical-wood.sprite")
    )
    (platform
      (running #f)
      (name "holdbot")
      (path-ref "fd5ef9d5-8937-4e2c-86db-0c7872193e15")
      (sprite "images/objects/platforms/vertical-wood.sprite")
    )
    (platform
      (running #f)
      (name "cageA")
      (path-ref "e140fcbf-56bd-4318-942a-3d0b9b083160")
      (sprite "images/objects/platforms/vertical-wood.sprite")
    )
    (platform
      (running #f)
      (name "cageB1")
      (path-ref "65219b96-552e-468c-ad86-d9ea65b6aa6b")
      (sprite "images/objects/platforms/vertical-wood.sprite")
    )
    (platform
      (running #f)
      (name "cageB2")
      (path-ref "4599be06-7e8f-4d12-87f7-9308c9bcaf4a")
      (sprite "images/objects/platforms/vertical-wood.sprite")
    )
    (platform
      (running #f)
      (name "cageC1")
      (path-ref "c0314d35-6a2d-4e9f-994c-9458ae002357")
      (sprite "images/objects/platforms/vertical-wood.sprite")
    )
    (platform
      (running #f)
      (name "cageC2")
      (path-ref "b6d03331-f955-49a9-9342-62a736800e9b")
      (sprite "images/objects/platforms/vertical-wood.sprite")
    )
    (platform
      (running #f)
      (name "cageC3")
      (path-ref "e8122dc9-2773-457d-baa8-0d6a21c720b3")
      (sprite "images/objects/platforms/vertical-wood.sprite")
    )
    (powerup
      (sprite "images/powerups/1up/1up.sprite")
      (x 864)
      (y 704)
    )
    (powerup
      (script "  Tux.add_bonus(\"iceflower\");  Tux.add_bonus(\"iceflower\");  Tux.add_bonus(\"iceflower\");  powerup();  ")
      (sprite "images/powerups/iceflower/iceflower.sprite")
      (x 864)
      (y 864)
    )
    (powerup
      (sprite "images/powerups/fireflower/fireflower.sprite")
      (x 864)
      (y 1024)
    )
    (scripttrigger
      (script "if(gate){  gate <- false;
        dropL1.goto_node(1);
        dropL2.goto_node(1);
        dropL3.goto_node(1);
        dropL4.goto_node(1);
        dropR1.goto_node(1);
        dropR2.goto_node(1);
        dropR3.goto_node(1);
        dropR4.goto_node(1);
        dropL1.goto_node(2);
        dropL2.goto_node(2);
        dropL3.goto_node(2);
        dropL4.goto_node(2);
        dropR1.goto_node(2);
        dropR2.goto_node(2);
        dropR3.goto_node(2);
        dropR4.goto_node(2);  }")
      (button #f)
      (width 320)
      (height 96)
      (x 256)
      (y 256)
    )
    (scripttrigger
      (script "
        cageA.goto_node(1);
        wait(  3  );
        cageB1.goto_node(1);
        cageB2.goto_node(1);
        wait(  3  );
        cageC1.goto_node(1);
        cageC2.goto_node(1);
        cageC3.goto_node(1);
        wait(  3  );
        holdtop.goto_node(1);
        holdmid.goto_node(1);
        holdbot.goto_node(1);  ")
      (button #f)
      (width 384)
      (height 32)
      (x 224)
      (y 1024)
    )
    (scripttrigger
      (script "  if(hidden){hidden <- false; find(\"ahole\");}  ")
      (button #f)
      (width 32)
      (height 32)
      (x 1168)
      (y 208)
    )
    (skullyhop
      (x 64)
      (y 704)
    )
    (skullyhop
      (x 64)
      (y 864)
    )
    (skullyhop
      (x 64)
      (y 1024)
    )
    (skullyhop
      (x 736)
      (y 704)
    )
    (skullyhop
      (x 736)
      (y 864)
    )
    (skullyhop
      (x 736)
      (y 1024)
    )
    (spawnpoint
      (name "main")
      (x 0)
      (y 256)
    )
    (tilemap
      (solid #t)
      (z-pos 0)
      (width 40)
      (height 36)
      (tiles
      0 0 0 0 0 0 0 0 0 0 0 0 0 0 0 0 0 0 0 0 0 0 0 10 11 11 11 11 11 11 11 11 11 11 11 11 11 11 11 11
      0 0 0 0 0 0 0 0 0 0 0 0 0 0 0 0 0 0 0 0 0 0 0 10 11 11 11 11 11 11 11 11 11 11 11 11 11 11 11 11
      0 0 0 0 0 0 0 0 0 0 0 0 0 0 0 0 0 0 0 0 0 0 0 0 0 0 0 0 0 0 0 0 0 11 11 30 17 17 31 11
      0 0 0 0 0 0 0 0 0 0 0 0 0 0 0 0 0 0 0 0 0 0 0 0 0 0 0 0 0 0 0 0 0 11 11 12 0 0 10 11
      0 0 0 0 0 0 0 0 0 0 0 0 0 0 0 0 0 0 0 0 0 0 0 0 0 0 0 0 0 0 0 0 0 11 11 12 0 0 10 11
      122 123 0 0 0 0 0 0 0 0 0 0 0 0 0 0 0 0 0 0 0 0 0 10 11 11 11 11 11 11 11 0 0 0 0 18 104 105 10 11
      124 125 0 0 0 0 0 0 0 0 0 0 0 0 0 0 0 0 0 0 0 0 0 10 11 11 11 11 11 11 11 0 0 0 0 0 0 0 10 11
      124 125 0 0 0 0 0 0 0 0 0 0 0 0 0 0 0 0 0 0 0 0 0 10 11 11 11 11 11 11 11 0 0 0 0 8 8 8 22 11
      124 125 0 0 0 0 0 0 0 0 0 0 0 0 0 0 0 0 0 0 0 0 0 10 11 11 11 11 11 11 11 11 11 11 11 14 14 14 23 11
      8 8 8 8 8 8 8 9 0 0 0 0 0 0 0 0 0 0 7 8 8 8 8 22 11 11 11 11 11 11 11 11 11 11 11 11 11 11 11 11
      14 14 14 14 14 14 14 15 0 0 0 0 0 0 0 0 0 0 13 14 14 14 14 23 11 11 11 11 11 11 11 11 11 11 11 11 11 11 11 11
      11 11 11 11 11 11 11 12 47 0 0 0 0 0 0 0 0 47 10 11 11 11 11 11 11 11 11 11 11 11 11 11 11 11 11 11 11 11 11 11
      11 11 11 11 11 11 11 12 0 0 0 0 0 0 0 0 0 0 10 11 11 11 11 11 11 11 11 11 11 11 11 11 11 11 11 11 11 11 11 11
      11 11 11 11 11 11 11 12 0 0 0 0 0 0 0 0 0 0 10 11 11 11 11 11 11 11 11 11 11 11 11 11 11 11 11 11 11 11 11 11
      11 11 11 11 11 11 11 12 0 0 0 0 0 0 0 0 0 0 10 11 11 11 11 11 11 11 11 11 11 11 11 11 11 11 11 11 11 11 11 11
      11 11 11 11 11 11 11 12 0 0 0 0 0 0 0 0 0 0 10 11 11 11 11 11 11 11 11 11 11 11 11 11 11 11 11 11 11 11 11 11
      11 11 11 11 11 11 11 12 0 0 0 0 0 0 0 0 0 0 10 11 11 11 11 11 11 11 11 11 11 11 11 11 11 11 11 11 11 11 11 11
      11 11 11 11 11 11 11 12 0 0 0 0 0 0 0 0 0 0 10 11 11 11 11 11 11 11 11 11 11 11 11 11 11 11 11 11 11 11 11 11
      11 11 11 11 11 11 11 12 0 0 0 0 0 0 0 0 0 0 10 11 11 11 11 11 11 11 11 11 11 11 11 11 11 11 11 11 11 11 11 11
      11 30 17 17 17 17 17 18 0 0 0 0 0 0 0 0 0 0 16 17 17 17 17 17 17 129 17 17 17 17 17 31 11 11 11 11 11 11 11 11
      11 12 0 0 0 0 0 0 0 0 0 0 0 0 0 0 0 0 0 0 0 0 0 0 0 0 133 0 0 0 0 16 17 31 11 11 11 11 11 11
      11 12 0 0 0 0 0 0 0 0 0 0 0 0 0 0 0 0 0 0 0 0 0 0 0 0 133 0 0 0 0 0 0 10 11 11 11 11 11 11
      11 21 8 8 8 9 0 0 0 0 0 0 0 0 0 0 0 0 0 0 0 0 0 0 0 0 133 0 0 0 0 0 0 16 17 31 11 11 11 11
      11 20 14 14 14 15 0 0 0 0 0 0 0 0 0 0 0 0 0 0 27 28 28 28 28 28 28 28 28 29 0 0 0 0 0 10 11 11 11 11
      11 30 17 17 17 18 0 0 0 0 0 0 0 0 0 0 0 0 0 0 0 0 0 0 0 0 133 0 0 0 0 0 0 0 0 16 17 31 11 11
      11 12 0 0 0 0 0 0 0 0 0 0 0 0 0 0 0 0 0 0 0 0 0 0 0 0 133 0 0 0 0 0 0 0 0 0 0 16 17 17
      11 12 0 0 0 0 0 0 0 0 0 0 0 0 0 0 0 0 0 0 0 0 0 0 0 0 133 0 0 0 0 0 0 0 0 0 0 0 0 132
      11 21 8 8 8 8 9 0 0 0 0 0 0 0 0 0 0 0 0 0 0 0 0 0 0 0 133 0 0 0 0 0 0 0 0 0 0 0 0 132
      11 20 14 14 14 14 15 0 0 0 0 0 0 0 0 0 0 0 0 27 28 28 28 28 28 28 28 28 28 28 29 0 0 0 0 0 0 0 0 132
      11 30 17 17 17 17 18 0 0 0 0 0 0 0 0 0 0 0 0 0 0 0 0 0 0 0 133 0 0 0 0 0 0 0 0 0 0 0 0 132
      11 12 0 0 0 0 0 0 0 0 0 0 0 0 0 0 0 0 0 0 0 0 0 0 0 0 133 0 0 0 0 0 0 0 0 0 0 0 0 132
      11 12 0 0 0 0 0 0 0 0 0 0 0 0 0 0 0 0 0 0 0 0 0 0 0 0 133 0 0 0 0 0 0 0 0 0 0 0 0 132
      11 21 8 8 8 8 8 8 8 8 8 8 8 8 8 8 8 8 8 8 8 8 8 8 9 0 133 7 8 8 8 8 8 8 8 8 8 8 8 8
      11 20 14 14 14 14 14 14 14 14 14 14 14 14 14 14 14 14 14 14 14 14 14 14 15 27 29 13 14 14 14 14 14 14 14 14 14 14 14 14
      11 11 11 11 11 11 11 11 11 11 11 11 11 11 11 11 11 11 11 11 11 11 11 11 12 0 0 10 11 11 11 11 11 11 11 11 11 11 11 11
      11 11 11 11 11 11 11 11 11 11 11 11 11 11 11 11 11 11 11 11 11 11 11 11 12 0 0 10 11 11 11 11 11 11 11 11 11 11 11 11
      )
    )
    (tilemap
      (solid #f)
      (z-pos 100)
      (width 40)
      (height 36)
      (tiles
      0 0 0 0 0 0 0 0 0 0 0 0 0 0 0 0 0 0 0 0 0 0 0 10 11 11 11 11 11 11 11 11 11 11 11 11 11 11 11 11
      0 0 0 0 0 0 0 0 0 0 0 0 0 0 0 0 0 0 0 0 0 0 0 10 11 11 11 11 11 11 11 11 11 11 11 11 11 11 11 11
      0 0 0 0 0 0 0 0 0 0 0 0 0 0 0 0 0 0 0 0 0 0 0 10 11 11 11 11 11 11 11 11 11 11 11 30 17 17 31 11
      0 0 0 0 0 0 0 0 0 0 0 0 0 0 0 0 0 0 0 0 0 0 0 10 11 11 11 11 11 11 11 11 11 11 11 12 0 0 10 11
      0 0 0 0 0 0 0 0 0 0 0 0 0 0 0 0 0 0 0 0 0 0 0 10 11 11 11 11 11 11 11 11 11 11 11 12 0 0 10 11
      0 0 0 0 0 0 0 0 0 0 0 0 0 0 0 0 0 0 0 0 0 0 0 10 11 11 11 11 11 11 11 11 11 11 11 12 0 0 10 11
      0 0 0 0 0 0 0 0 0 0 0 0 0 0 0 0 0 0 0 0 0 0 0 10 11 11 11 11 11 11 11 11 11 11 11 12 0 0 10 11
      0 0 0 0 0 0 0 0 0 0 0 0 0 0 0 0 0 0 0 0 0 0 0 10 11 11 11 11 11 11 11 11 11 11 11 21 8 8 22 11
      0 0 0 0 0 0 0 0 0 0 0 0 0 0 0 0 0 0 0 0 0 0 0 10 11 11 11 11 11 11 11 11 11 11 11 20 14 14 23 11
      0 0 0 0 0 0 0 0 0 0 0 0 0 0 0 0 0 0 0 0 0 0 0 0 0 0 0 0 0 0 0 0 0 0 0 0 0 0 0 0
      0 0 0 0 0 0 0 0 0 0 0 0 0 0 0 0 0 0 0 0 0 0 0 0 0 0 0 0 0 0 0 0 0 0 0 0 0 0 0 0
      0 0 0 0 0 0 0 0 0 0 0 0 0 0 0 0 0 0 0 0 0 0 0 0 0 0 0 0 0 0 0 0 0 0 0 0 0 0 0 0
      11 11 11 11 11 11 11 12 0 0 0 0 0 0 0 0 0 0 10 11 11 11 11 11 11 11 0 0 0 0 0 0 0 0 0 0 0 0 0 0
      11 11 11 11 11 11 11 12 0 0 0 0 0 0 0 0 0 0 10 11 11 11 11 11 11 11 0 0 0 0 0 0 0 0 0 0 0 0 0 0
      11 11 11 11 11 11 11 12 0 0 0 0 0 0 0 0 0 0 10 11 11 11 11 11 11 11 0 0 0 0 0 0 0 0 0 0 0 0 0 0
      11 11 11 11 11 11 11 12 0 0 0 0 0 0 0 0 0 0 10 11 11 11 11 11 11 11 0 0 0 0 0 0 0 0 0 0 0 0 0 0
      11 11 11 11 11 11 11 12 0 0 0 0 0 0 0 0 0 0 10 11 11 11 11 11 11 11 0 0 0 0 0 0 0 0 0 0 0 0 0 0
      11 11 11 11 11 11 11 12 0 0 0 0 0 0 0 0 0 0 10 11 11 11 11 11 11 11 0 0 0 0 0 0 0 0 0 0 0 0 0 0
      11 11 11 11 11 11 11 12 0 0 0 0 0 0 0 0 0 0 10 11 11 11 11 11 11 11 0 0 0 0 0 0 0 0 0 0 0 0 0 0
      11 30 17 17 17 17 17 18 0 0 0 0 0 0 0 0 0 0 16 17 17 17 17 17 17 17 0 0 0 0 0 0 0 0 0 0 0 0 0 0
      0 0 0 0 0 0 0 0 0 0 0 0 0 0 0 0 0 0 0 0 0 0 0 0 0 129 0 0 0 0 0 0 0 0 0 0 0 0 0 0
      0 0 0 0 0 0 0 0 0 0 0 0 0 0 0 0 0 0 0 0 0 0 0 0 0 129 0 0 0 0 0 0 0 0 0 0 0 0 0 0
      0 0 0 0 0 0 0 0 0 0 0 0 0 0 0 0 0 0 0 0 0 0 0 0 0 129 0 0 0 0 0 0 0 0 0 0 0 0 0 0
      0 0 14 14 14 15 0 0 0 0 0 0 0 0 0 0 0 0 0 0 27 28 28 28 28 28 0 0 0 0 0 0 0 0 0 0 0 0 0 0
      0 0 17 17 17 18 0 0 0 0 0 0 0 0 0 0 0 0 0 0 0 0 0 0 0 129 0 0 0 0 0 0 0 0 0 0 0 0 0 0
      0 0 0 0 0 0 0 0 0 0 0 0 0 0 0 0 0 0 0 0 0 0 0 0 0 129 0 0 0 0 0 0 0 0 0 0 0 0 0 0
      0 0 0 0 0 0 0 0 0 0 0 0 0 0 0 0 0 0 0 0 0 0 0 0 0 129 0 0 0 0 0 0 0 0 0 0 0 0 0 0
      0 0 0 0 0 0 0 0 0 0 0 0 0 0 0 0 0 0 0 0 0 0 0 0 0 129 0 0 0 0 0 0 0 0 0 0 0 0 0 0
      0 0 14 14 14 14 15 0 0 0 0 0 0 0 0 0 0 0 0 27 28 28 28 28 28 28 0 0 0 0 0 0 0 0 0 0 0 0 0 0
      0 0 17 17 17 17 18 0 0 0 0 0 0 0 0 0 0 0 0 0 0 0 0 0 0 129 0 0 0 0 0 0 0 0 0 0 0 0 0 0
      0 0 0 0 0 0 0 0 0 0 0 0 0 0 0 0 0 0 0 0 0 0 0 0 0 129 0 0 0 0 0 0 0 0 0 0 0 0 0 0
      0 0 0 0 0 0 0 0 0 0 0 0 0 0 0 0 0 0 0 0 0 0 0 0 0 129 0 0 0 0 0 0 0 0 0 0 0 0 0 0
      0 0 0 0 0 0 0 0 0 0 0 0 0 0 0 0 0 0 0 0 0 0 0 0 0 129 0 0 0 0 0 0 0 0 0 0 0 0 0 0
      0 0 14 14 14 14 14 14 14 14 14 14 14 14 14 14 14 14 14 14 14 14 14 14 15 0 0 0 0 0 0 0 0 0 0 0 0 0 0 0
      0 0 11 11 11 11 11 11 11 11 11 11 11 11 11 11 11 11 11 11 11 11 11 11 12 0 0 0 0 0 0 0 0 0 0 0 0 0 0 0
      0 0 11 11 11 11 11 11 11 11 11 11 11 11 11 11 11 11 11 11 11 11 11 11 12 0 0 0 0 0 0 0 0 0 0 0 0 0 0 0
      )
    )
    (tilemap
      (solid #f)
      (z-pos -100)
      (width 40)
      (height 36)
      (tiles
      0 0 0 0 0 0 0 0 0 0 0 0 0 0 0 0 0 0 0 0 0 0 0 0 0 0 0 0 0 0 0 0 0 0 0 0 0 0 0 0
      0 0 0 0 0 0 0 0 0 0 0 0 0 0 0 0 0 0 0 0 0 0 0 0 0 0 0 0 0 0 0 0 0 0 0 0 0 0 0 0
      0 0 0 0 0 0 0 0 0 0 0 0 0 0 0 0 0 0 0 0 0 0 0 0 0 0 0 0 0 0 0 0 0 0 0 0 0 0 0 0
      0 0 0 0 0 0 0 0 0 0 0 0 0 0 0 0 0 0 0 0 0 0 0 0 0 0 0 0 0 0 0 0 0 0 0 0 0 0 0 0
      0 0 0 0 0 0 0 0 0 0 0 0 0 0 0 0 0 0 0 0 0 0 0 0 0 0 0 0 0 0 0 0 0 0 0 0 0 0 0 0
      122 123 0 0 0 0 0 0 0 0 0 0 0 0 0 0 0 0 0 0 0 0 0 0 0 0 0 0 0 0 0 0 0 0 0 0 0 0 0 0
      124 125 0 0 0 0 0 0 0 0 0 0 0 0 0 0 0 0 0 0 0 0 0 0 0 0 0 0 0 0 0 0 0 0 0 0 0 0 0 0
      124 125 0 0 0 0 0 0 0 0 0 0 0 0 0 0 0 0 0 0 0 0 0 0 0 0 0 0 0 0 0 0 0 0 0 0 0 0 0 0
      124 125 0 122 123 0 0 0 0 0 0 0 0 0 0 0 0 0 0 0 0 0 0 0 0 0 0 0 0 0 0 0 0 0 0 0 0 0 0 0
      124 125 0 124 125 0 0 0 0 0 0 0 0 0 0 0 0 0 0 0 0 0 0 0 0 0 0 0 0 0 0 0 0 0 0 0 0 0 0 0
      32 32 32 32 32 32 32 32 32 32 32 32 32 32 32 32 32 32 32 32 32 32 32 32 32 32 32 32 32 32 32 32 32 32 32 32 32 32 32 32
      36 36 36 36 36 36 36 36 36 36 36 36 36 36 36 36 36 36 36 36 36 36 36 36 36 36 36 36 36 36 36 36 36 36 36 36 36 36 36 36
      36 36 36 36 36 36 36 36 36 36 36 36 36 36 36 36 36 36 36 36 36 36 36 36 36 36 36 36 36 36 36 36 36 36 36 36 36 36 36 36
      36 36 36 36 36 36 36 36 36 36 36 36 36 36 36 36 36 36 36 36 36 36 36 36 36 36 36 36 36 36 36 36 36 36 36 36 36 36 36 36
      36 36 36 36 36 36 36 36 36 36 36 36 36 36 36 36 36 36 36 36 36 36 36 36 36 36 36 36 36 36 36 36 36 36 36 36 36 36 36 36
      36 36 36 36 36 36 36 36 36 36 36 36 36 36 36 36 36 36 36 36 36 36 36 36 36 36 36 36 36 36 36 36 36 36 36 36 36 36 36 36
      36 36 36 36 36 36 36 36 36 36 36 36 36 36 36 36 36 36 36 36 36 36 36 36 36 36 36 36 36 36 36 36 36 36 36 36 36 36 36 36
      36 36 36 36 36 36 36 36 36 36 36 36 36 36 36 36 36 36 36 36 36 36 36 36 36 36 36 36 36 36 36 36 36 36 36 36 36 36 36 36
      36 36 36 36 36 36 36 36 36 36 36 36 36 36 36 36 36 36 36 36 36 36 36 36 36 36 36 36 36 36 36 36 36 36 36 36 36 36 36 36
      36 36 36 36 36 36 36 36 36 36 36 36 36 36 36 36 36 36 36 36 36 36 36 36 36 36 36 36 36 36 36 36 36 36 36 36 36 36 36 36
      36 36 36 36 36 36 36 36 36 36 36 36 36 36 36 36 36 36 36 36 36 36 36 36 36 36 36 36 36 36 36 36 36 36 36 36 36 36 36 36
      36 36 36 36 36 36 36 36 36 36 36 36 36 36 36 36 36 36 36 36 36 36 36 36 36 36 36 36 36 36 36 36 36 36 36 36 36 36 36 36
      36 36 36 36 36 36 36 36 36 36 36 36 36 36 36 36 36 36 36 36 36 36 36 36 36 36 36 36 36 36 36 36 36 36 36 36 36 36 36 36
      36 36 36 36 36 36 36 36 36 36 36 36 36 36 36 36 36 36 36 36 36 36 36 36 36 36 36 36 36 36 36 36 36 36 36 36 36 36 36 36
      36 36 36 36 36 36 36 36 36 36 36 36 36 36 36 36 36 36 36 36 36 36 36 36 36 36 36 36 36 36 36 36 36 36 36 36 36 36 36 36
      36 36 36 36 36 36 36 36 36 36 36 36 36 36 36 36 36 36 36 36 36 36 36 36 36 36 36 36 36 36 36 36 36 36 36 36 36 36 36 36
      36 36 36 36 36 36 36 36 36 36 36 36 36 36 36 36 36 36 36 36 36 36 36 36 36 36 36 36 36 36 36 36 36 36 36 36 36 36 36 36
      36 36 36 36 36 36 36 36 36 36 36 36 36 36 36 36 36 36 36 36 36 36 36 36 36 36 36 36 36 36 36 36 36 36 36 36 36 36 36 36
      36 36 36 36 36 36 36 36 36 36 36 36 36 36 36 36 36 36 36 36 36 36 36 36 36 36 36 36 36 36 36 36 36 36 36 36 36 36 36 36
      36 36 36 36 36 36 36 36 36 36 36 36 36 36 36 36 36 36 36 36 36 36 36 36 36 36 36 36 36 36 36 36 36 36 36 36 36 36 36 36
      36 36 36 36 36 36 36 36 36 36 36 36 36 36 36 36 36 36 36 36 36 36 36 36 36 36 36 36 36 36 36 36 36 36 36 36 36 36 36 36
      36 36 36 36 36 36 36 36 36 36 36 36 36 36 36 36 36 36 36 36 36 36 36 36 36 36 36 36 36 36 36 36 36 36 36 36 36 36 36 36
      36 36 36 36 36 36 36 36 36 36 36 36 36 36 36 36 36 36 36 36 36 36 36 36 36 36 36 36 36 36 36 36 36 36 36 36 36 36 36 36
      36 36 36 36 36 36 36 36 36 36 36 36 36 36 36 36 36 36 36 36 36 36 36 36 36 36 36 36 36 36 36 36 36 36 36 36 36 36 36 36
      36 36 36 36 36 36 36 36 36 36 36 36 36 36 36 36 36 36 36 36 36 36 36 36 36 36 36 36 36 36 36 36 36 36 36 36 36 36 36 36
      36 36 36 36 36 36 36 36 36 36 36 36 36 36 36 36 36 36 36 36 36 36 36 36 36 36 36 36 36 36 36 36 36 36 36 36 36 36 36 36
      )
    )
  )
)
