(supertux-level
  (version 2)
  (name (_ "Den of the Iceborer"))
  (author "LMH")
  (contact "lmh.0013@gmail.com")
  (license "GPL 2 / CC-by-sa 3.0")
  (sector
    (name "main")
    (music "music/airship_remix.ogg")
    (init-script "  import(\"levels/mattie_world/doom_islands/Iceborer.nut\");  running <- false;  ")
    (ambient-light 1 1 1)
    (camera
      (mode "normal")
    )
    (gradient
      (top_color 0 0 0)
      (bottom_color 1 1 1)
    )
    (spawnpoint
      (name "main")
      (x 64)
      (y 320)
    )
    (scripttrigger
      (script "  prepare_iceborer();  ")
      (button #f)
      (width 4)
      (height 384)
      (x 96)
      (y 0)
    )
    (scripttrigger
      (script "  begin_iceborer_battle();  ")
      (button #f)
      (width 4)
      (height 384)
      (x 208)
      (y 0)
    )
    (scripttrigger
      (script "  hit <- true;  ")
      (button #f)
      (width 960)
      (height 4)
      (x 160)
      (y 32)
    )
    (trampoline
      (portable #f)
      (x 176)
      (y 672)
    )
    (trampoline
      (portable #f)
      (x 208)
      (y 672)
    )
    (tilemap
      (solid #t)
      (z-pos 0)
      (name "Interactive")
      (width 40)
      (height 25)
      (tiles
      0 0 0 0 0 0 0 0 0 0 0 0 0 0 0 0 0 0 0 0 0 0 0 0 0 0 0 0 0 0 0 0 0 0 0 0 0 0 0 0
      0 0 0 0 0 0 0 0 0 0 0 0 0 0 0 0 0 0 0 0 0 0 0 0 0 0 0 0 0 0 0 0 0 0 0 0 0 0 0 0
      0 0 0 0 0 0 0 0 0 0 0 0 0 0 0 0 0 0 0 0 0 0 0 0 0 0 0 0 0 0 0 0 0 0 0 0 0 0 0 0
      0 0 0 0 0 0 0 0 0 0 0 0 0 0 0 0 0 0 0 0 0 0 0 0 0 0 0 0 0 0 0 0 0 0 0 0 0 0 0 0
      0 0 0 0 0 0 0 0 0 0 0 0 0 0 0 0 0 0 0 0 0 0 0 0 0 0 0 0 0 0 0 0 0 0 0 0 0 0 0 0
      0 0 0 0 0 0 0 0 0 0 0 0 0 0 0 0 0 0 0 0 0 0 0 0 0 0 0 0 0 0 0 0 0 0 0 0 0 0 0 0
      0 0 0 0 0 0 0 0 0 0 0 0 0 0 0 0 0 0 0 0 0 0 0 0 0 0 0 0 0 0 0 0 0 0 0 0 0 0 0 0
      0 0 0 0 0 0 0 0 0 0 0 0 0 0 0 0 0 0 0 0 0 0 0 0 0 0 0 0 0 0 0 0 0 0 0 0 0 0 0 0
      0 0 0 0 0 0 0 0 0 0 0 0 0 0 0 0 0 0 0 0 0 0 0 0 0 0 0 0 0 0 0 0 0 0 0 0 0 0 0 0
      0 0 0 0 0 0 0 0 0 0 0 0 0 0 0 0 0 0 0 0 0 0 0 0 0 0 0 0 0 0 0 0 0 0 0 0 0 0 0 0
      0 0 0 0 0 0 0 0 0 0 0 0 0 0 0 0 0 0 0 0 0 0 0 0 0 0 0 0 0 0 0 0 0 0 0 0 0 0 0 0
      8 8 8 8 9 0 0 0 0 0 0 0 0 0 0 0 0 0 0 0 0 0 0 0 0 0 0 0 0 0 0 0 0 0 0 7 8 8 8 8
      14 14 14 14 15 77 77 77 77 77 77 77 77 77 77 77 77 77 77 77 77 77 77 77 77 77 77 77 77 77 77 77 77 77 77 13 14 14 14 14
      11 11 11 11 12 77 77 77 77 77 77 77 77 77 77 77 77 77 77 77 77 77 77 77 77 77 77 77 77 77 77 77 77 77 77 10 11 11 11 11
      11 11 11 11 12 77 77 77 77 77 77 77 77 77 77 77 77 77 77 77 77 77 77 77 77 77 77 77 77 77 77 77 77 77 77 10 11 11 11 11
      11 11 11 11 12 77 77 77 77 77 77 77 77 77 77 77 77 77 77 77 77 77 77 77 77 77 77 77 77 77 77 77 77 77 77 10 11 11 11 11
      11 11 11 11 12 77 77 77 77 77 77 77 77 77 77 77 77 77 77 77 77 77 77 77 77 77 77 77 77 77 77 77 77 77 77 10 11 11 11 11
      11 11 11 11 12 77 77 77 77 77 77 77 77 77 77 77 77 77 77 77 77 77 77 77 77 77 77 77 77 77 77 77 77 77 77 10 11 11 11 11
      11 11 11 11 12 77 77 77 77 77 77 77 77 77 77 77 77 77 77 77 77 77 77 77 77 77 77 77 77 77 77 77 77 77 77 10 11 11 11 11
      11 11 11 11 12 77 77 77 77 77 77 77 77 77 77 77 77 77 77 77 77 77 77 77 77 77 77 77 77 77 77 77 77 77 77 10 11 11 11 11
      11 11 11 11 12 0 0 0 0 0 0 0 0 0 0 0 0 0 0 0 0 0 0 0 0 0 0 0 0 0 0 0 0 0 0 10 11 11 11 11
      11 11 11 11 12 0 0 0 0 0 0 0 0 0 0 0 0 0 0 0 0 0 0 0 0 0 0 0 0 0 0 0 0 0 0 10 11 11 11 11
      11 11 11 11 12 0 0 0 0 0 0 0 0 0 0 0 0 0 0 0 0 0 0 0 0 0 0 0 0 0 0 0 0 0 0 10 11 11 11 11
      11 11 11 11 12 0 0 0 0 0 0 0 0 0 0 0 0 0 0 0 0 0 0 0 0 0 0 0 0 0 0 0 0 0 0 10 11 11 11 11
      11 11 11 11 12 0 0 0 0 0 0 0 0 0 0 0 0 0 0 0 0 0 0 0 0 0 0 0 0 0 0 0 0 0 0 10 11 11 11 11
      )
    )
    (tilemap
      (solid #t)
      (z-pos 50)
      (name "deliver")
      (path
        (node
          (x 144)
          (y 672)
          (time 0.1)
        )
        (node
          (x 240)
          (y 672)
          (time 0.1)
        )
        (node
          (x 336)
          (y 672)
          (time 0.1)
        )
        (node
          (x 432)
          (y 672)
          (time 0.1)
        )
        (node
          (x 528)
          (y 672)
          (time 0.1)
        )
        (node
          (x 624)
          (y 672)
          (time 0.1)
        )
        (node
          (x 720)
          (y 672)
          (time 0.1)
        )
        (node
          (x 816)
          (y 672)
          (time 0.1)
        )
        (node
          (x 912)
          (y 672)
          (time 0.1)
        )
        (node
          (x 1008)
          (y 672)
          (time 0.1)
        )
      )
      (width 4)
      (height 2)
      (tiles
      1311 131 131 1311
      1311 1311 1311 1311
      )
    )
    (tilemap
      (solid #t)
      (alpha 0)
      (z-pos 0)
      (name "bounceNbreak")
      (path
        (node
          (x 144)
          (y 672)
        )
        (node
          (x 144)
          (y 288)
          (time 2)
        )
        (node
          (x 144)
          (y 672)
          (time 3)
        )
        (node
          (x 720)
          (y 672)
        )
        (node
          (x 720)
          (y 304)
          (time 2)
        )
        (node
          (x 720)
          (y 672)
          (time 3)
        )
        (node
          (x 432)
          (y 672)
        )
        (node
          (x 432)
          (y 288)
          (time 2)
        )
        (node
          (x 432)
          (y 672)
          (time 3)
        )
        (node
          (x 1008)
          (y 672)
        )
        (node
          (x 1008)
          (y 288)
          (time 2)
        )
        (node
          (x 1008)
          (y 672)
          (time 3)
        )
        (node
          (x 528)
          (y 672)
        )
        (node
          (x 528)
          (y 288)
          (time 2)
        )
        (node
          (x 528)
          (y 672)
          (time 3)
        )
        (node
          (x 240)
          (y 672)
        )
        (node
          (x 240)
          (y 256)
          (time 2)
        )
        (node
          (x 240)
          (y 672)
          (time 3)
        )
        (node
          (x 816)
          (y 672)
        )
        (node
          (x 816)
          (y 288)
          (time 2)
        )
        (node
          (x 816)
          (y 672)
          (time 3)
        )
        (node
          (x 336)
          (y 672)
        )
        (node
          (x 336)
          (y 288)
          (time 2)
        )
        (node
          (x 336)
          (y 672)
          (time 3)
        )
        (node
          (x 912)
          (y 672)
        )
        (node
          (x 912)
          (y 256)
          (time 2)
        )
        (node
          (x 912)
          (y 672)
          (time 3)
        )
        (node
          (x 624)
          (y 672)
        )
        (node
          (x 624)
          (y 288)
          (time 2)
        )
        (node
          (x 624)
          (y 672)
          (time 3)
        )
      )
      (width 4)
      (height 4)
      (tiles
      2820 0 0 2819
      0 48 48 0
      2820 0 0 2819
      0 48 48 0
      )
    )
    (tilemap
      (solid #t)
      (alpha 0)
      (z-pos -10)
      (name "pain")
      (path
        (node
          (x 160)
          (y 640)
        )
        (node
          (x 160)
          (y 288)
          (time 2)
        )
        (node
          (x 160)
          (y 640)
          (time 3)
        )
        (node
          (x 736)
          (y 640)
        )
        (node
          (x 736)
          (y 304)
          (time 2)
        )
        (node
          (x 736)
          (y 640)
          (time 3)
        )
        (node
          (x 448)
          (y 640)
        )
        (node
          (x 448)
          (y 288)
          (time 2)
        )
        (node
          (x 448)
          (y 640)
          (time 3)
        )
        (node
          (x 1024)
          (y 640)
        )
        (node
          (x 1024)
          (y 288)
          (time 2)
        )
        (node
          (x 1024)
          (y 640)
          (time 3)
        )
        (node
          (x 544)
          (y 640)
        )
        (node
          (x 544)
          (y 288)
          (time 2)
        )
        (node
          (x 544)
          (y 640)
          (time 3)
        )
        (node
          (x 256)
          (y 640)
        )
        (node
          (x 256)
          (y 256)
          (time 2)
        )
        (node
          (x 256)
          (y 640)
          (time 3)
        )
        (node
          (x 832)
          (y 640)
        )
        (node
          (x 832)
          (y 288)
          (time 2)
        )
        (node
          (x 832)
          (y 640)
          (time 3)
        )
        (node
          (x 352)
          (y 640)
        )
        (node
          (x 352)
          (y 288)
          (time 2)
        )
        (node
          (x 352)
          (y 640)
          (time 3)
        )
        (node
          (x 928)
          (y 640)
        )
        (node
          (x 928)
          (y 256)
          (time 2)
        )
        (node
          (x 928)
          (y 640)
          (time 3)
        )
        (node
          (x 640)
          (y 640)
        )
        (node
          (x 640)
          (y 288)
          (time 2)
        )
        (node
          (x 640)
          (y 640)
          (time 3)
        )
      )
      (width 3)
      (height 5)
      (tiles
      0 295 0
      298 0 296
      298 0 296
      298 0 296
      298 0 296
      )
    )
    (tilemap
      (solid #t)
      (z-pos -10)
      (name "walls")
      (path
        (node
          (x 64)
          (y 384)
        )
        (node
          (x 64)
          (y -32)
        )
      )
      (width 36)
      (height 13)
      (tiles
      84 84 84 0 0 0 0 0 0 0 0 0 0 0 0 0 0 0 0 0 0 0 0 0 0 0 0 0 0 0 0 0 0 84 84 84
      84 84 84 0 0 0 0 0 0 0 0 0 0 0 0 0 0 0 0 0 0 0 0 0 0 0 0 0 0 0 0 0 0 84 84 84
      84 84 84 0 0 0 0 0 0 0 0 0 0 0 0 0 0 0 0 0 0 0 0 0 0 0 0 0 0 0 0 0 0 84 84 84
      84 84 84 0 0 0 0 0 0 0 0 0 0 0 0 0 0 0 0 0 0 0 0 0 0 0 0 0 0 0 0 0 0 84 84 84
      84 84 84 0 0 0 0 0 0 0 0 0 0 0 0 0 0 0 0 0 0 0 0 0 0 0 0 0 0 0 0 0 0 84 84 84
      84 84 84 0 0 0 0 0 0 0 0 0 0 0 0 0 0 0 0 0 0 0 0 0 0 0 0 0 0 0 0 0 0 84 84 84
      84 84 84 0 0 0 0 0 0 0 0 0 0 0 0 0 0 0 0 0 0 0 0 0 0 0 0 0 0 0 0 0 0 84 84 84
      84 84 84 0 0 0 0 0 0 0 0 0 0 0 0 0 0 0 0 0 0 0 0 0 0 0 0 0 0 0 0 0 0 84 84 84
      84 84 84 0 0 0 0 0 0 0 0 0 0 0 0 0 0 0 0 0 0 0 0 0 0 0 0 0 0 0 0 0 0 84 84 84
      84 84 84 0 0 0 0 0 0 0 0 0 0 0 0 0 0 0 0 0 0 0 0 0 0 0 0 0 0 0 0 0 0 84 84 84
      84 84 84 0 0 0 0 0 0 0 0 0 0 0 0 0 0 0 0 0 0 0 0 0 0 0 0 0 0 0 0 0 0 84 84 84
      84 84 84 0 0 0 0 0 0 0 0 0 0 0 0 0 0 0 0 0 0 0 0 0 0 0 0 0 0 0 0 0 0 84 84 84
      84 84 84 0 0 0 0 0 0 0 0 0 0 0 0 0 0 0 0 0 0 0 0 0 0 0 0 0 0 0 0 0 0 84 84 84
      )
    )
  )
)
