(supertux-level
  (version 2)
  (name (_ "Decrepit Yeti"))
  (author "LMH")
  (contact "lmh.0013@gmail.com")
  (license "GPL 2 / CC-by-sa 3.0")
  (sector
    (name "main")
    (music "music/bossattack.ogg")
    (init-script "      ")
    (ambient-light 1 1 1)
    (camera
      (mode "normal")
    )
    (gradient
      (top_color 0 0 0)
      (bottom_color 0.4 0.4 0.4)
    )
    (spawnpoint
      (name "main")
      (x 624)
      (y 0)
    )
    (yeti
      (dead-script "sector.Tux.trigger_sequence(\"fireworks\");")
      (x 64)
      (y 320)
    )
    (yeti_stalactite
      (x 48)
      (y 224)
    )
    (yeti_stalactite
      (x 80)
      (y 224)
    )
    (yeti_stalactite
      (x 112)
      (y 224)
    )
    (yeti_stalactite
      (x 144)
      (y 224)
    )
    (yeti_stalactite
      (x 176)
      (y 224)
    )
    (yeti_stalactite
      (x 208)
      (y 224)
    )
    (unstable_tile
      (sprite "images/objects/unstable_tile/snow.sprite")
      (x 576)
      (y 544)
    )
    (unstable_tile
      (sprite "images/objects/unstable_tile/snow.sprite")
      (x 608)
      (y 544)
    )
    (unstable_tile
      (sprite "images/objects/unstable_tile/snow.sprite")
      (x 640)
      (y 544)
    )
    (unstable_tile
      (sprite "images/objects/unstable_tile/snow.sprite")
      (x 672)
      (y 544)
    )
    (yeti_stalactite
      (x 1040)
      (y 224)
    )
    (yeti_stalactite
      (x 1072)
      (y 224)
    )
    (yeti_stalactite
      (x 1104)
      (y 224)
    )
    (yeti_stalactite
      (x 1136)
      (y 224)
    )
    (yeti_stalactite
      (x 1168)
      (y 224)
    )
    (yeti_stalactite
      (x 1200)
      (y 224)
    )
    (dispenser
      (cycle 7)
      (type "cannon")
      (badguy "bouncingsnowball")
      (direction "right")
      (x 352)
      (y 96)
    )
    (dispenser
      (cycle 6.5)
      (type "cannon")
      (badguy "bouncingsnowball")
      (direction "left")
      (x 1216)
      (y 96)
    )
    (rock
      (x 777)
      (y 32)
    )
    (rock
      (x 902)
      (y 33)
    )
    (rock
      (x 939)
      (y 34)
    )
    (tilemap
      (solid #t)
      (z-pos 0)
      (name "Interactive")
      (width 40)
      (height 25)
      (tiles 0 0 0 0 0 0 0 0 0 0 0 0 0 0 0 0 0 0 0 0 0 0 0 0 0 0 0 0 0 0 0 0 0 0 0 0 0 0 0 0 8 8 8 8 8 8 8 8 8 8 8 8 8 8 8 8 9 0 0 0 0 0 0 7 8 8 8 8 8 8 8 8 8 8 8 8 8 8 8 8 14 14 14 14 14 14 14 14 14 14 14 14 14 14 14 14 15 0 0 0 0 0 0 13 14 14 14 14 14 14 14 14 14 14 14 14 14 14 14 14 11 11 11 11 11 11 11 11 11 11 30 2820 7 8 8 8 9 0 0 0 0 0 0 7 8 8 8 8 8 8 8 8 8 8 8 8 8 9 2819 31 11 11 11 11 11 11 11 11 11 11 21 8 114 14 14 14 15 0 0 0 0 0 0 13 14 14 14 14 14 14 14 14 14 14 14 14 14 113 8 22 11 11 11 11 11 11 11 11 11 11 20 14 23 11 11 11 12 0 0 0 0 0 0 10 11 11 11 11 11 11 11 11 11 11 11 11 11 20 14 23 11 11 11 11 11 11 11 11 11 11 11 11 11 11 11 11 12 0 0 0 0 0 0 10 11 11 11 11 11 11 11 11 11 11 11 11 11 11 11 11 30 17 17 17 17 17 17 17 31 11 11 11 11 11 11 11 12 0 0 0 0 0 0 10 11 11 11 11 11 11 11 30 17 17 17 17 17 17 17 31 12 0 0 0 0 0 0 0 16 17 31 11 11 11 11 11 12 0 0 0 0 0 0 10 11 11 11 11 11 30 17 18 0 0 0 0 0 0 0 10 12 0 0 0 0 0 0 0 0 0 16 17 17 31 11 11 12 0 0 0 0 0 0 10 11 11 30 17 17 18 0 0 0 0 0 0 0 0 0 10 12 0 0 0 0 0 0 0 0 0 0 0 0 16 17 17 18 0 0 0 0 0 0 16 17 17 18 0 0 0 0 0 0 0 0 0 0 0 0 10 12 0 0 0 0 0 0 0 0 0 0 0 0 0 0 0 0 0 0 0 0 0 0 0 0 0 0 0 0 0 0 0 0 0 0 0 0 0 0 10 12 0 0 0 0 0 0 0 0 0 0 0 0 0 0 0 0 0 0 0 0 0 0 0 0 0 0 0 0 0 0 0 0 0 0 0 0 0 0 10 21 8 8 8 8 9 0 0 0 0 0 0 0 0 0 0 0 0 0 0 0 0 0 0 0 0 0 0 0 0 0 0 0 0 7 8 8 8 8 22 20 14 14 14 14 15 0 0 0 0 0 0 0 0 0 0 0 0 0 0 0 0 0 0 0 0 0 0 0 0 0 0 0 0 13 14 14 14 14 23 11 11 11 11 11 12 0 0 0 0 0 0 0 0 0 0 0 0 0 0 0 0 0 0 0 0 0 0 0 0 0 0 0 0 10 11 11 11 11 11 11 11 11 11 11 12 0 0 0 0 0 0 0 0 0 0 0 0 0 0 0 0 0 0 0 0 0 0 0 0 0 0 0 0 10 11 11 11 11 11 11 11 11 11 11 12 0 0 0 0 0 0 0 0 0 0 0 0 0 0 0 0 0 0 0 0 0 0 0 0 0 0 0 0 10 11 11 11 11 11 11 11 11 11 11 12 0 0 0 0 0 0 0 0 0 0 0 0 0 0 0 0 0 0 0 0 0 0 0 0 0 0 0 0 10 11 11 11 11 11 11 11 11 11 11 12 0 0 0 0 0 0 0 0 0 0 0 0 0 0 0 0 0 0 0 0 0 0 0 0 0 0 0 0 10 11 11 11 11 11 11 11 11 11 11 12 0 0 0 0 0 7 8 8 8 8 8 8 8 8 8 8 8 8 8 8 8 8 9 0 0 0 0 0 10 11 11 11 11 11 11 11 11 11 11 12 0 0 0 0 0 13 14 14 14 14 14 14 14 14 14 14 14 14 14 14 14 14 15 0 0 0 0 0 10 11 11 11 11 11 11 11 11 11 11 21 8 8 8 8 8 22 11 11 11 11 11 11 11 11 11 11 11 11 11 11 11 11 21 8 8 8 8 8 22 11 11 11 11 11 11 11 11 11 11 20 14 14 14 14 14 23 11 11 11 11 11 11 11 11 11 11 11 11 11 11 11 11 20 14 14 14 14 14 23 11 11 11 11 11 11 11 11 11 11 11 11 11 11 11 11 11 11 11 11 11 11 11 11 11 11 11 11 11 11 11 11 11 11 11 11 11 11 11 11 11 11 11 11 11)
    )
    (tilemap
      (solid #t)
      (z-pos -100)
      (name "Background")
      (width 40)
      (height 25)
      (tiles 1795 1795 1795 1796 1795 1797 1797 1795 1795 1796 1796 1795 1797 1795 1795 1795 1798 0 0 0 0 0 0 0 0 0 0 0 0 0 0 0 0 0 0 0 0 0 0 0 1795 1797 1795 1796 1796 1796 1797 1796 1795 1795 1797 1795 1795 1796 1795 1797 1798 0 0 0 0 0 0 0 0 0 0 0 0 0 0 0 0 0 0 0 0 0 0 0 0 0 0 0 0 0 0 0 0 0 0 0 0 0 0 0 0 0 0 0 0 0 0 0 0 0 0 0 0 0 0 0 0 0 0 0 0 0 0 0 0 0 0 0 0 0 0 0 0 0 0 17 17 17 17 17 18 0 0 0 0 0 0 16 17 17 17 17 17 17 17 17 17 17 17 17 17 17 17 0 0 0 0 0 0 0 0 0 0 0 0 0 0 0 0 0 0 0 0 0 0 0 0 0 0 0 0 0 0 0 0 0 0 0 0 0 0 0 0 0 0 0 0 0 0 0 0 0 0 0 0 0 0 0 0 0 0 0 0 0 0 0 0 0 0 0 0 0 0 0 0 0 0 0 0 0 0 0 0 0 0 0 0 0 0 0 0 0 0 0 0 0 0 0 0 0 0 0 0 0 0 0 0 0 0 0 0 0 0 0 0 0 0 0 0 0 0 0 0 0 0 0 0 0 0 0 0 0 0 0 0 0 0 0 0 0 0 0 0 0 0 0 0 0 0 0 0 0 0 0 0 0 0 0 0 0 0 0 0 0 0 0 0 0 0 0 0 0 0 0 0 0 0 0 0 0 0 0 0 0 0 0 0 0 0 0 0 0 0 0 0 0 0 0 0 0 0 0 0 0 0 0 0 0 0 0 0 0 0 0 0 0 0 0 0 0 0 0 0 0 0 0 0 0 0 0 0 0 0 0 0 0 0 0 0 0 0 0 0 0 0 0 0 0 0 0 0 0 0 0 0 0 0 0 0 0 0 0 0 0 0 0 0 0 0 0 0 0 0 0 0 0 0 0 0 0 0 0 0 0 0 0 0 0 0 0 0 0 0 0 0 0 0 0 0 0 0 0 0 0 0 0 0 0 0 0 0 0 0 0 0 0 0 0 0 0 0 0 0 0 0 0 0 0 0 0 0 0 0 0 0 0 0 0 0 0 0 0 2052 2053 2053 2054 0 0 0 0 0 0 0 0 0 0 0 0 0 0 0 0 0 0 0 0 0 0 0 0 0 0 0 0 0 0 0 0 0 0 0 2052 2056 2070 2071 2055 2054 0 0 0 0 0 0 0 0 0 0 0 0 0 0 0 0 0 0 0 0 0 0 0 0 0 0 0 0 0 0 0 0 0 0 2057 2070 2066 2070 2066 2059 0 0 0 0 0 0 0 0 0 0 0 0 0 0 0 0 0 0 0 0 0 0 0 0 0 0 0 0 0 0 0 0 0 2052 2056 2070 2070 2066 2066 2055 2054 0 0 0 0 0 0 0 0 0 0 0 0 0 0 0 0 0 0 0 0 0 0 0 0 0 0 0 0 0 0 0 0 2057 2058 2066 2066 2066 2066 2058 2059 0 0 0 0 0 0 0 0 0 0 0 0 0 0 0 0 0 0 0 0 0 0 0 0 0 0 0 0 0 0 0 0 2057 2071 2050 2063 2063 2051 2070 2059 0 0 0 0 0 0 0 0 0 0 0 0 0 0 0 0 0 0 0 0 0 0 0 0 0 0 0 0 0 0 0 0 2062 2051 2055 2053 2053 2056 2050 2064 0 0 0 0 0 0 0 0 0 0 0 0 0 0 0 0 0 0 0 17 17 18 0 0 0 0 0 0 0 0 0 0 0 2057 2066 2065 2061 2060 2059 0 0 0 0 0 0 0 0 0 0 0 0 0 0 0 0 0 0 0 0 0 0 0 0 0 0 0 0 0 0 0 0 2052 2053 2056 2060 2061 2065 2066 2055 2053 2054 0 0 0 0 0 0 0 0 0 16 17 17 0 0 0 0 0 0 0 0 0 0 0 0 0 0 0 0 0 0 0 0 0 0 0 0 0 0 0 0 0 0 0 0 0 0 0 0 0 0 0 0 0 0 0 0 0 0 0 0 0 2178 2178 2178 2178 2178 0 0 0 0 0 0 0 0 0 0 0 0 0 0 0 0 0 0 2178 2178 2178 2178 2178 0 0 0 0 0 0 0 0 0 0 0 0 0 0 0 0 0 0 0 0 0 0 0 0 0 0 0 0 0 0 0 0 0 0 0 0 0 0 0 0 0 0 0 0 0 0 0 0 0 0 0 0 0 0 0 0 0 0 0 0 0 0 0 0 0 0 0 0 0 0 0 0 0 0 0 0 0 0 0 0 0 0 0 0 0 0)
    )
  )
)
