(supertux-level
  (version 2)
  (name (_ "Three-yetis combo! (boss)"))
  (author "hume")
  (license "GPL 2+ / CC-by-sa 3.0")
  (sector
    (name "main")
    (music "music/fortress.ogg")
    (ambient-light 0 0 0)
    (camera
      (mode "normal")
    )
    (background
      (speed 1)
      (image-top "images/background/snowcastle.png")
      (image "images/background/snowcastle.png")
      (image-bottom "images/background/snowcastle.png")
    )
    (trampoline
      (portable #f)
      (x 96)
      (y 416)
    )
    (pushbutton
      (script "chain.goto_node(1);")
      (x 2256)
      (y 592)
    )
    (pushbutton
      (script "cag.goto_node(1);")
      (x 0)
      (y 48)
    )
    (spawnpoint
      (name "main")
      (x 32)
      (y 256)
    )
    (tilemap
      (solid #t)
      (speed 5)
      (z-pos 0)
      (width 75)
      (height 20)
      (tiles
      0 0 0 0 0 0 0 0 0 0 0 0 0 0 0 0 0 0 0 0 0 0 0 0 0 0 0 0 0 0 0 0 0 0 0 0 0 0 0 0 0 0 0 0 0 0 0 0 0 0 0 0 0 0 0 0 0 0 0 0 0 0 0 0 0 0 0 0 0 0 0 0 0 0 0
      0 0 0 0 0 0 0 0 0 0 0 0 0 0 0 0 0 0 0 0 0 0 0 0 0 0 0 0 0 0 0 0 0 0 0 0 0 0 0 0 0 0 0 0 0 0 0 0 0 0 0 0 0 0 0 0 0 0 0 0 0 0 0 0 0 0 0 0 0 0 0 0 0 0 0
      1763 48 48 0 0 0 0 0 0 0 0 0 0 0 0 0 0 0 0 0 0 0 0 0 0 0 0 0 0 0 0 0 0 0 0 0 0 0 0 0 0 0 0 0 0 0 0 0 0 0 0 0 0 0 0 0 0 0 0 0 0 0 0 0 0 0 0 0 0 0 0 0 48 48 48
      1765 0 0 0 0 0 0 0 0 0 0 0 0 0 0 0 0 0 0 0 0 0 0 0 0 0 0 0 0 0 0 0 0 0 0 0 0 0 0 0 0 0 0 0 0 0 0 0 0 0 0 0 0 0 0 0 0 0 0 0 0 0 0 0 0 0 0 0 0 0 0 0 0 0 48
      1767 0 0 0 0 0 0 0 0 0 0 0 0 0 0 0 0 0 0 0 0 0 0 0 0 0 0 0 0 0 0 0 0 0 0 0 0 0 0 0 0 0 0 0 0 0 0 0 0 0 0 0 0 0 0 0 0 0 0 0 0 0 0 0 0 0 0 0 0 0 0 0 0 0 48
      1769 0 0 0 0 0 0 0 0 0 0 0 0 0 0 0 0 0 0 0 0 0 0 0 0 0 0 0 0 0 0 0 0 0 0 0 0 0 0 0 0 0 0 0 0 0 0 0 0 0 0 0 0 0 0 0 0 0 0 0 0 0 0 0 0 0 0 0 0 0 0 0 0 0 48
      1771 0 0 0 0 0 0 0 0 0 0 0 0 0 0 0 0 0 0 0 0 0 0 0 0 0 0 0 0 0 0 0 0 0 0 0 0 0 0 0 0 0 0 0 0 0 0 0 0 0 0 0 0 0 0 0 0 0 0 0 0 0 0 0 0 0 0 0 0 0 0 0 0 0 48
      1773 0 0 0 0 0 0 0 0 0 0 0 0 0 0 0 0 0 0 0 0 0 0 0 0 0 0 0 0 0 0 0 0 0 0 0 0 0 0 0 0 0 0 0 0 0 0 0 0 0 0 0 0 0 0 0 0 0 0 0 0 0 0 0 0 0 0 0 0 0 0 0 0 0 48
      1763 0 0 0 0 0 0 0 0 0 0 0 0 0 0 0 0 0 0 0 0 0 0 0 0 0 0 0 0 0 0 0 0 0 0 0 0 0 0 0 0 0 0 0 0 0 0 0 0 0 0 0 0 0 0 0 0 0 0 0 0 0 0 0 0 0 0 0 0 0 0 0 0 0 48
      1765 0 0 0 0 0 0 0 0 0 0 0 0 0 0 0 0 0 0 0 0 0 0 0 0 0 0 0 0 0 0 0 0 0 0 0 0 0 0 0 0 0 0 0 0 0 0 0 0 0 0 0 0 0 0 0 0 0 0 0 0 0 0 0 0 0 0 0 0 0 0 0 0 0 48
      1767 0 0 0 0 0 0 0 0 0 0 0 0 0 0 0 0 0 0 0 0 0 0 0 0 0 0 0 0 0 0 0 0 0 0 0 0 0 0 0 0 0 0 0 0 0 0 0 0 0 0 0 0 0 0 0 0 0 0 0 0 0 0 0 0 0 0 0 0 0 0 0 0 0 48
      1769 0 0 0 0 0 0 0 0 0 0 0 0 0 0 0 0 0 0 0 0 0 0 0 0 0 0 0 0 0 0 0 0 0 0 0 0 0 0 0 0 0 0 0 0 0 0 0 0 0 0 0 0 0 0 0 0 0 0 0 0 0 0 0 0 0 0 0 0 0 0 0 0 0 48
      1771 0 0 0 0 0 0 0 0 0 0 0 0 0 0 0 0 0 0 0 0 0 0 0 0 0 0 0 0 0 0 0 0 0 0 0 0 0 0 0 0 0 0 0 0 0 0 0 0 0 0 0 0 0 0 0 0 0 0 0 0 0 0 0 0 0 0 0 0 0 0 0 0 0 48
      1773 0 0 0 0 0 0 0 0 0 0 0 0 0 0 0 0 0 0 0 0 0 0 0 0 0 0 0 0 0 0 0 0 0 0 0 0 0 0 0 0 0 0 0 0 0 0 0 0 0 0 0 0 0 0 0 0 0 0 0 0 0 0 0 0 0 0 0 0 0 0 0 0 0 48
      1762 1763 1762 1763 0 0 0 0 1762 1763 0 0 0 0 0 1762 1763 0 0 0 0 1762 1763 0 0 0 0 0 1762 1763 0 0 0 0 0 1762 1763 0 0 0 0 0 1762 1763 0 0 0 0 0 1762 1763 0 0 0 0 0 0 1762 1763 0 0 0 0 0 0 0 0 0 0 0 0 0 0 0 1348
      1764 1765 1764 1765 0 0 0 0 1764 1765 0 0 0 0 0 1764 1765 0 0 0 0 1764 1765 0 0 0 0 0 1764 1765 0 0 0 0 0 1764 1765 0 0 0 0 0 1764 1765 0 0 0 0 0 1764 1765 0 0 0 0 0 0 1764 1765 0 0 0 0 0 0 0 0 0 0 0 0 0 0 0 79
      1766 1767 1766 1767 0 0 0 0 1766 1767 0 0 0 0 0 1766 1767 0 0 0 0 1766 1767 0 0 0 0 0 1766 1767 0 0 0 0 0 1766 1767 0 0 0 0 0 1766 1767 0 0 0 0 0 1766 1767 0 0 0 0 0 0 1766 1767 0 0 0 0 0 0 0 0 0 0 0 0 0 0 0 79
      1768 1769 1768 1769 0 0 0 0 1768 1769 0 0 0 0 0 1768 1769 0 0 0 0 1768 1769 0 0 0 0 0 1768 1769 0 0 0 0 0 1768 1769 0 0 0 0 0 1768 1769 0 0 0 0 0 1768 1769 0 0 0 0 0 0 1768 1769 0 0 0 0 0 0 0 0 0 0 0 0 0 47 0 79
      1770 1771 1770 1771 0 0 0 0 1770 1771 0 0 0 0 0 1770 1771 0 0 0 0 1770 1771 0 0 0 0 0 1770 1771 0 0 0 0 0 1770 1771 0 0 0 0 0 1770 1771 0 0 0 0 0 1770 1771 0 0 0 0 0 0 1770 1771 0 0 0 0 0 0 0 0 0 0 0 0 0 47 47 79
      1772 1773 1772 1773 0 0 0 0 1772 1773 0 0 0 0 0 1772 1773 0 0 0 0 1772 1773 0 0 0 0 0 1772 1773 0 0 0 0 0 1772 1773 0 0 0 0 0 1772 1773 0 0 0 0 0 1772 1773 0 0 0 0 0 0 1772 1773 0 0 0 0 0 1772 1773 1772 1773 1772 1773 1772 1773 1772 1773 79
      )
    )
    (tilemap
      (solid #t)
      (z-pos 0)
      (name "chain")
      (path
        (node
          (x 0)
          (y -32)
          (time 5)
        )
        (node
          (x 0)
          (y 448)
          (time 5)
        )
      )
      (width 75)
      (height 1)
      (tiles
      0 0 0 0 47 2812 2808 47 0 0 47 2812 2808 2810 47 0 0 47 2808 2810 47 0 0 47 2808 2810 2812 47 0 0 47 2810 2812 2808 47 0 0 47 2812 2808 2810 47 0 0 47 2808 2810 2812 47 0 0 47 2810 2812 2808 2810 47 0 0 47 2812 2808 2810 2812 2808 2810 2812 2808 2810 2812 2808 2810 2812 2808 47
      )
    )
    (tilemap
      (solid #t)
      (z-pos 0)
      (path
        (node
          (x 0)
          (y -1000)
          (time 5)
        )
      )
      (width 75)
      (height 20)
      (tiles
      48 48 48 48 48 48 48 48 48 48 48 48 48 48 48 48 48 48 48 48 48 48 48 48 48 48 48 48 48 48 48 48 48 48 48 48 48 48 48 48 48 48 48 48 48 48 48 48 48 48 48 48 48 48 48 48 48 48 48 48 48 48 48 48 48 48 48 48 48 48 48 48 48 48 48
      48 0 0 0 0 0 0 0 0 0 0 0 0 0 0 0 0 0 0 0 0 0 0 0 0 0 0 0 0 0 0 0 0 0 0 0 0 0 0 0 0 0 0 0 0 0 0 0 0 0 0 0 0 0 0 0 0 0 0 0 0 0 0 0 0 0 0 0 0 0 0 0 0 0 48
      48 0 0 0 0 0 0 0 0 0 0 0 0 0 0 0 0 0 0 0 0 0 0 0 0 0 0 0 0 0 0 0 0 0 0 0 0 0 0 0 0 0 0 0 0 0 0 0 0 0 0 0 0 0 0 0 0 0 0 0 0 0 0 0 0 0 0 0 0 0 0 0 0 0 48
      48 0 0 0 0 0 0 0 0 0 0 0 0 0 0 0 0 0 0 0 0 0 0 0 0 0 0 0 0 0 0 0 0 0 0 0 0 0 0 0 0 0 0 0 0 0 0 0 0 0 0 0 0 0 0 0 0 0 0 0 0 0 0 0 0 0 0 0 0 0 0 0 0 0 48
      48 0 0 0 0 0 0 0 0 0 0 0 0 0 0 0 0 0 0 0 0 0 0 0 0 0 0 0 0 0 0 0 0 0 0 0 0 0 0 0 0 0 0 0 0 0 0 0 0 0 0 0 0 0 0 0 0 0 0 0 0 0 0 0 0 0 0 0 0 0 0 0 0 0 48
      48 0 0 0 0 0 0 0 0 0 0 0 0 0 0 0 0 0 0 0 0 0 0 0 0 0 0 0 0 0 0 0 0 0 0 0 0 0 0 0 0 0 0 0 0 0 0 0 0 0 0 0 0 0 0 0 0 0 0 0 0 0 0 0 0 0 0 0 0 0 0 0 0 0 48
      48 0 0 0 0 0 0 0 0 0 0 0 0 0 0 0 0 0 0 0 0 0 0 0 0 0 0 0 0 0 0 0 0 0 0 0 0 0 0 0 0 0 0 0 0 0 0 0 0 0 0 0 0 0 0 0 0 0 0 0 0 0 0 0 0 0 0 0 0 0 0 0 0 0 48
      48 0 0 0 0 0 0 0 0 0 0 0 0 0 0 0 0 0 0 0 0 0 0 0 0 0 0 0 0 0 0 0 0 0 0 0 0 0 0 0 0 0 0 0 0 0 0 0 0 0 0 0 0 0 0 0 0 0 0 0 0 0 0 0 0 0 0 0 0 0 0 0 0 0 48
      48 0 0 0 0 0 0 0 0 0 0 0 0 0 0 0 0 0 0 0 0 0 0 0 0 0 0 0 0 0 0 0 0 0 0 0 0 0 0 0 0 0 0 0 0 0 0 0 0 0 0 0 0 0 0 0 0 0 0 0 0 0 0 0 0 0 0 0 0 0 0 0 0 0 48
      48 0 0 0 0 0 0 0 0 0 0 0 0 0 0 0 0 0 0 0 0 0 0 0 0 0 0 0 0 0 0 0 0 0 0 0 0 0 0 0 0 0 0 0 0 0 0 0 0 0 0 0 0 0 0 0 0 0 0 0 0 0 0 0 0 0 0 0 0 0 0 0 0 0 48
      48 0 0 0 0 0 0 0 0 0 0 0 0 0 0 0 0 0 0 0 0 0 0 0 0 0 0 0 0 0 0 0 0 0 0 0 0 0 0 0 0 0 0 0 0 0 0 0 0 0 0 0 0 0 0 0 0 0 0 0 0 0 0 0 0 0 0 0 0 0 0 0 0 0 48
      48 0 0 0 0 0 0 0 0 0 0 0 0 0 0 0 0 0 0 0 0 0 0 0 0 0 0 0 0 0 0 0 0 0 0 0 0 0 0 0 0 0 0 0 0 0 0 0 0 0 0 0 0 0 0 0 0 0 0 0 0 0 0 0 0 0 0 0 0 0 0 0 0 0 48
      48 0 0 0 0 0 0 0 0 0 0 0 0 0 0 0 0 0 0 0 0 0 0 0 0 0 0 0 0 0 0 0 0 0 0 0 0 0 0 0 0 0 0 0 0 0 0 0 0 0 0 0 0 0 0 0 0 0 0 0 0 0 0 0 0 0 0 0 0 0 0 0 0 0 48
      48 0 0 0 0 0 0 0 0 0 0 0 0 0 0 0 0 0 0 0 0 0 0 0 0 0 0 0 0 0 0 0 0 0 0 0 0 0 0 0 0 0 0 0 0 0 0 0 0 0 0 0 0 0 0 0 0 0 0 0 0 0 0 0 0 0 0 0 0 0 0 0 0 0 48
      48 0 0 0 0 0 0 0 0 0 0 0 0 0 0 0 0 0 0 0 0 0 0 0 0 0 0 0 0 0 0 0 0 0 0 0 0 0 0 0 0 0 0 0 0 0 0 0 0 0 0 0 0 0 0 0 0 0 0 0 0 0 0 0 0 0 0 0 0 0 0 0 0 0 48
      48 0 0 0 0 0 0 0 0 0 0 0 0 0 0 0 0 0 0 0 0 0 0 0 0 0 0 0 0 0 0 0 0 0 0 0 0 0 0 0 0 0 0 0 0 0 0 0 0 0 0 0 0 0 0 0 0 0 0 0 0 0 0 0 0 0 0 0 0 0 0 0 0 0 48
      48 0 0 0 0 0 0 0 0 0 0 0 0 0 0 0 0 0 0 0 0 0 0 0 0 0 0 0 0 0 0 0 0 0 0 0 0 0 0 0 0 0 0 0 0 0 0 0 0 0 0 0 0 0 0 0 0 0 0 0 0 0 0 0 0 0 0 0 0 0 0 0 0 0 48
      48 0 0 0 0 0 0 0 0 0 0 0 0 0 0 0 0 0 0 0 0 0 0 0 0 0 0 0 0 0 0 0 0 0 0 0 0 0 0 0 0 0 0 0 0 0 0 0 0 0 0 0 0 0 0 0 0 0 0 0 0 0 0 0 0 0 0 0 0 0 0 0 0 0 48
      48 0 0 0 0 0 0 0 0 0 0 0 0 0 0 0 0 0 0 0 0 0 0 0 0 0 0 0 0 0 0 0 0 0 0 0 0 0 0 0 0 0 0 0 0 0 0 0 0 0 0 0 0 0 0 0 0 0 0 0 0 0 0 0 0 0 0 0 0 0 0 0 0 0 48
      48 0 0 0 0 0 0 0 0 0 0 0 0 0 0 0 0 0 0 0 0 0 0 0 0 0 0 0 0 0 0 0 0 0 0 0 0 0 0 0 0 0 0 0 0 0 0 0 0 0 0 0 0 0 0 0 0 0 0 0 0 0 0 0 0 0 0 0 0 0 0 0 0 0 48
      )
    )
    (tilemap
      (solid #t)
      (z-pos 0)
      (name "cag")
      (path
        (node
          (x 0)
          (y -360)
          (time 0.1)
        )
        (node
          (x 2400)
          (y -360)
          (time 5)
        )
      )
      (width 75)
      (height 1)
      (tiles
      48 48 48 48 48 48 48 48 48 48 48 48 48 48 48 48 48 48 48 48 48 48 48 48 48 48 48 48 48 48 48 48 48 48 48 48 48 48 48 48 48 48 48 48 48 48 48 48 48 48 48 48 48 48 48 48 48 48 48 48 48 48 48 48 48 48 48 48 48 48 48 48 48 48 48
      )
    )
    (yeti
      (dead-script "settings.set_ambient_light(1,settings.get_ambient_green(),settings.get_ambient_blue());
          if ((settings.get_ambient_green()==1)){if ((settings.get_ambient_blue()==1)){
          sector.Tux.trigger_sequence(\"fireworks\")
          import(\"levels/hume/defualt.nut\");
          unlock_archivement(\"ab\")}}")
      (x 500)
      (y -750)
    )
    (yeti
      (dead-script "settings.set_ambient_light(settings.get_ambient_red(),1,settings.get_ambient_blue());
          if ((settings.get_ambient_red()==1)){if ((settings.get_ambient_blue()==1)){
          sector.Tux.trigger_sequence(\"fireworks\")
          import(\"levels/hume/defualt.nut\");
          unlock_archivement(\"ab\")}}")
      (x 500)
      (y -750)
    )
    (yeti
      (dead-script "settings.set_ambient_light(settings.get_ambient_red(),settings.get_ambient_green(),1);
          if ((settings.get_ambient_green()==1)){if ((settings.get_ambient_blue()==1)){
          sector.Tux.trigger_sequence(\"fireworks\")
          import(\"levels/hume/defualt.nut\");
          unlock_archivement(\"ab\")}}")
      (x 500)
      (y -750)
    )
    (crystallo
      (radius 32)
      (x 160)
      (y -64)
    )
    (crystallo
      (radius 32)
      (x 352)
      (y -64)
    )
    (crystallo
      (radius 32)
      (x 576)
      (y -64)
    )
    (crystallo
      (radius 32)
      (x 768)
      (y -64)
    )
    (crystallo
      (radius 32)
      (x 992)
      (y -64)
    )
    (crystallo
      (radius 32)
      (x 1148)
      (y -64)
    )
    (crystallo
      (radius 32)
      (x 1440)
      (y -64)
    )
    (crystallo
      (radius 32)
      (x 1664)
      (y -64)
    )
    (crystallo
      (radius 32)
      (x 1888)
      (y -64)
    )
    (candle
      (x 320)
      (y 416)
    )
    (candle
      (x 640)
      (y 416)
    )
    (candle
      (x 960)
      (y 416)
    )
    (candle
      (x 1280)
      (y 416)
    )
    (candle
      (x 1600)
      (y 416)
    )
    (candle
      (x 1920)
      (y 416)
    )
    (candle
      (x 2240)
      (y 416)
    )
    (candle
      (x 2560)
      (y 416)
    )
    (candle
      (x 2380)
      (y 416)
    )
    (candle
      (x 0)
      (y 416)
    )
    (candle
      (x 0)
      (y 0)
    )
  )
)
